ActivatorMechanism~LavaCaves~MOD:	Title='Mechanism <color=yellow>Lava Caves</color>', Desc=''
AlchemyTable~ElvenPalace~MOD:	Title='Alchemy Table <color=yellow>Elven Palace</color>', Desc=''
AlchemyTable~Stronghold~MOD:	Title='Alchemy Table <color=yellow>Stronghold</color>', Desc=''
Altar_A~Catacombs~MOD:	Title='Altar <color=yellow>Catacombs</color>', Desc=''
Altar_A~Necropolis~MOD:	Title='Altar <color=yellow>Necropolis</color>', Desc=''
Altar_B~Catacombs~MOD:	Title='Altar <color=yellow>Catacombs</color>', Desc=''
Altar_B~Necropolis~MOD:	Title='Altar <color=yellow>Necropolis</color>', Desc=''
Altar_C~Catacombs~MOD:	Title='Altar <color=yellow>Catacombs</color>', Desc=''
Altar_C~Necropolis~MOD:	Title='Altar <color=yellow>Necropolis</color>', Desc=''
Altar_D~Catacombs~MOD:	Title='Altar <color=yellow>Catacombs</color>', Desc=''
Altar_D~Necropolis~MOD:	Title='Altar <color=yellow>Necropolis</color>', Desc=''
Altar_E~Catacombs~MOD:	Title='Altar <color=yellow>Catacombs</color>', Desc=''
Altar_E~Necropolis~MOD:	Title='Altar <color=yellow>Necropolis</color>', Desc=''
Arch_A~Sewers~MOD:	Title='Arch <color=yellow>Sewers</color>', Desc=''
Arch_B~Sewers~MOD:	Title='Arch <color=yellow>Sewers</color>', Desc=''
Arch_C~Sewers~MOD:	Title='Arch <color=yellow>Sewers</color>', Desc=''
Arch_D~Sewers~MOD:	Title='Arch <color=yellow>Sewers</color>', Desc=''
ArmorStandProp~Stronghold~MOD:	Title='Armor Stand <color=yellow>Stronghold</color>', Desc=''
ArmorStandProp~TownInterior~MOD:	Title='Armor Stand <color=yellow>Town Interiors</color>', Desc=''
Banner_A~Stronghold~MOD:	Title='Banner <color=yellow>Stronghold</color>', Desc=''
Banner_B~Stronghold~MOD:	Title='Banner <color=yellow>Stronghold</color>', Desc=''
Banner_C~Stronghold~MOD:	Title='Banner <color=yellow>Stronghold</color>', Desc=''
Banner_D~Stronghold~MOD:	Title='Banner <color=yellow>Stronghold</color>', Desc=''
Banner_E~LavaCaves~MOD:	Title='Banner <color=yellow>Lava Caves</color>', Desc=''
Banner_F~LavaCaves~MOD:	Title='Banner <color=yellow>Lava Caves</color>', Desc=''
Banner_G~LavaCaves~MOD:	Title='Banner <color=yellow>Lava Caves</color>', Desc=''
BannerColumn_A~Town~MOD:	Title='Banner <color=yellow>Town</color>', Desc=''
BannerColumn_B~Town~MOD:	Title='Banner <color=yellow>Town</color>', Desc=''
BannerColumn_C~Town~MOD:	Title='Banner <color=yellow>Town</color>', Desc=''
BannerColumn_D~Town~MOD:	Title='Banner <color=yellow>Town</color>', Desc=''
BannerColumn_E~Town~MOD:	Title='Banner <color=yellow>Town</color>', Desc=''
BannerColumn_F~Town~MOD:	Title='Banner <color=yellow>Town</color>', Desc=''
BannerColumn_G~Town~MOD:	Title='Banner <color=yellow>Town</color>', Desc=''
BannerColumn_H~Town~MOD:	Title='Banner <color=yellow>Town</color>', Desc=''
BannerColumn_I~Town~MOD:	Title='Banner <color=yellow>Town</color>', Desc=''
BannerColumn_J~Town~MOD:	Title='Banner <color=yellow>Town</color>', Desc=''
BannerColumn_K~Town~MOD:	Title='Banner <color=yellow>Town</color>', Desc=''
BarCounter~TownInterior~MOD:	Title='Tavern Counter <color=yellow>Town Interiors</color>', Desc=''
Barrack~Town~MOD:	Title='Barrak <color=yellow>Town</color>', Desc=''
Barrel_A~Town~MOD:	Title='Barrels <color=yellow>Town</color>', Desc=''
Barrel_A~TownInterior~MOD:	Title='Barrels <color=yellow>Town Interiors</color>', Desc=''
Barrel_A~WoodLand~MOD:	Title='Barrels <color=yellow>Woodland</color>', Desc=''
Barrel_B~Town~MOD:	Title='Barrels <color=yellow>Town</color>', Desc=''
Barrel_B~TownInterior~MOD:	Title='Barrels <color=yellow>Town Interiors</color>', Desc=''
Barrel_B~WoodLand~MOD:	Title='Barrels <color=yellow>Woodland</color>', Desc=''
Barrel_C~Town~MOD:	Title='Barrels <color=yellow>Town</color>', Desc=''
Barrel_C~TownInterior~MOD:	Title='Barrels <color=yellow>Town Interiors</color>', Desc=''
Barrel_C~WoodLand~MOD:	Title='Barrels <color=yellow>Woodland</color>', Desc=''
Barrel_Street_A~Town~MOD:	Title='Barrels <color=yellow>Town</color>', Desc=''
Barrel_Street_B~Town~MOD:	Title='Barrels <color=yellow>Town</color>', Desc=''
Barrel_Street_C~Town~MOD:	Title='Barrels <color=yellow>Town</color>', Desc=''
Barrels~Catacombs~MOD:	Title='Barrels <color=yellow>Catacombs</color>', Desc=''
Barrels~ElvenPalace~MOD:	Title='Barrels <color=yellow>Elven Palace</color>', Desc=''
Barrels~LavaCaves~MOD:	Title='Barrels <color=yellow>Lava Caves</color>', Desc=''
Barrels~Stronghold~MOD:	Title='Barrels <color=yellow>Stronghold</color>', Desc=''
Barrels~Town~MOD:	Title='Barrels <color=yellow>Town</color>', Desc=''
Barrels~TownInterior~MOD:	Title='Barrels <color=yellow>Town Interiors</color>', Desc=''
Barrels~WoodLand~MOD:	Title='Barrels <color=yellow>Woodland</color>', Desc=''
BarrelStack~Catacombs~MOD:	Title='Barrel Stack <color=yellow>Catacombs</color>', Desc=''
BarrelStack~ElvenPalace~MOD:	Title='Barrel Stack <color=yellow>Elven Palace</color>', Desc=''
BarrelStack~LavaCaves~MOD:	Title='Barrel Stack <color=yellow>Lava Caves</color>', Desc=''
BarrelStack~Stronghold~MOD:	Title='Barrel Stack <color=yellow>Stronghold</color>', Desc=''
BarrelStack~Town~MOD:	Title='Barrel Stack <color=yellow>Town</color>', Desc=''
BarrelStack~TownInterior~MOD:	Title='Barrel Stack <color=yellow>Town Interiors</color>', Desc=''
BarrelStack~WoodLand~MOD:	Title='Barrel Stack <color=yellow>Woodland</color>', Desc=''
BarrelTavern_A~TownInterior~MOD:	Title='Barrels <color=yellow>Town Interiors</color>', Desc=''
Basket_A~Catacombs~MOD:	Title='Basket <color=yellow>Catacombs</color>', Desc=''
Basket_A~LavaCaves~MOD:	Title='Basket <color=yellow>Lava Caves</color>', Desc=''
Basket_A~Town~MOD:	Title='Basket <color=yellow>Town</color>', Desc=''
Basket_A~TownInterior~MOD:	Title='Basket <color=yellow>Town Interiors</color>', Desc=''
Basket_A~WoodLand~MOD:	Title='Basket <color=yellow>Woodland</color>', Desc=''
Basket_B~Catacombs~MOD:	Title='Basket <color=yellow>Catacombs</color>', Desc=''
Basket_B~LavaCaves~MOD:	Title='Basket <color=yellow>Lava Caves</color>', Desc=''
Basket_B~Town~MOD:	Title='Basket <color=yellow>Town</color>', Desc=''
Basket_B~TownInterior~MOD:	Title='Basket <color=yellow>Town Interiors</color>', Desc=''
Basket_B~WoodLand~MOD:	Title='Basket <color=yellow>Woodland</color>', Desc=''
Beam~TownInterior~MOD:	Title='Column <color=yellow>Town Interiors</color>', Desc=''
BeamScreen_A~TownInterior~MOD:	Title='Beam Screen <color=yellow>Town Interiors</color>', Desc=''
BeamScreen_B~TownInterior~MOD:	Title='Beam Screen <color=yellow>Town Interiors</color>', Desc=''
Bed_A~ElvenPalace~MOD:	Title='Bed <color=yellow>Elven Palace</color>', Desc=''
Bed_A~Stronghold~MOD:	Title='Bed <color=yellow>Stronghold</color>', Desc=''
Bed_A~TownInterior~MOD:	Title='Bed <color=yellow>Town Interiors</color>', Desc=''
Bed_A~WoodLand~MOD:	Title='Bed <color=yellow>Woodland</color>', Desc=''
Bed_B~ElvenPalace~MOD:	Title='Bed <color=yellow>Elven Palace</color>', Desc=''
Bed_B~Stronghold~MOD:	Title='Bed <color=yellow>Stronghold</color>', Desc=''
Bed_B~TownInterior~MOD:	Title='Bed <color=yellow>Town Interiors</color>', Desc=''
Bed_C~Stronghold~MOD:	Title='Bed <color=yellow>Stronghold</color>', Desc=''
Bed_C~TownInterior~MOD:	Title='Bed <color=yellow>Town Interiors</color>', Desc=''
Bed_C~WoodLand~MOD:	Title='Bed <color=yellow>Woodland</color>', Desc=''
Bedroll_A~Catacombs~MOD:	Title='Bedroll <color=yellow>Catacombs</color>', Desc=''
Bedroll_A~LavaCaves~MOD:	Title='Bedroll <color=yellow>Lava Caves</color>', Desc=''
Bedroll_A~Sewers~MOD:	Title='Bedroll <color=yellow>Sewers</color>', Desc=''
Bedroll_A~WoodLand~MOD:	Title='Bedroll <color=yellow>Woodland</color>', Desc=''
Bedroll_B~Catacombs~MOD:	Title='Bedroll <color=yellow>Catacombs</color>', Desc=''
Bedroll_B~LavaCaves~MOD:	Title='Bedroll <color=yellow>Lava Caves</color>', Desc=''
Bedroll_B~Sewers~MOD:	Title='Bedroll <color=yellow>Sewers</color>', Desc=''
Bedroll_B~WoodLand~MOD:	Title='Bedroll <color=yellow>Woodland</color>', Desc=''
Bedroll_C~Catacombs~MOD:	Title='Bedroll <color=yellow>Catacombs</color>', Desc=''
Bedroll_C~LavaCaves~MOD:	Title='Bedroll <color=yellow>Lava Caves</color>', Desc=''
Bedroll_C~Sewers~MOD:	Title='Bedroll <color=yellow>Sewers</color>', Desc=''
Bedroll_C~WoodLand~MOD:	Title='Bedroll <color=yellow>Woodland</color>', Desc=''
Bedroll_D~Catacombs~MOD:	Title='Bedroll <color=yellow>Catacombs</color>', Desc=''
Bedroll_D~LavaCaves~MOD:	Title='Bedroll <color=yellow>Lava Caves</color>', Desc=''
Bedroll_D~Sewers~MOD:	Title='Bedroll <color=yellow>Sewers</color>', Desc=''
Bedroll_D~WoodLand~MOD:	Title='Bedroll <color=yellow>Woodland</color>', Desc=''
Bedroll_Tent_A~WoodLand~MOD:	Title='Tent <color=yellow>Woodland</color>', Desc=''
Bedroll_Tent_B~WoodLand~MOD:	Title='Tent <color=yellow>Woodland</color>', Desc=''
Bench_A~Catacombs~MOD:	Title='Bench <color=yellow>Catacombs</color>', Desc=''
Bench_A~ElvenPalace~MOD:	Title='Bench <color=yellow>Elven Palace</color>', Desc=''
Bench_A~Necropolis~MOD:	Title='Bench <color=yellow>Necropolis</color>', Desc=''
Bench_A~Sewers~MOD:	Title='Bench <color=yellow>Sewers</color>', Desc=''
Bench_A~Stronghold~MOD:	Title='Bench <color=yellow>Stronghold</color>', Desc=''
Bench_A~TownInterior~MOD:	Title='Bench <color=yellow>Town Interiors</color>', Desc=''
Bench_A~WoodLand~MOD:	Title='Bench <color=yellow>Woodland</color>', Desc=''
Bench_B~Catacombs~MOD:	Title='Bench <color=yellow>Catacombs</color>', Desc=''
Bench_B~ElvenPalace~MOD:	Title='Bench <color=yellow>Elven Palace</color>', Desc=''
Bench_B~Sewers~MOD:	Title='Bench <color=yellow>Sewers</color>', Desc=''
Bench_B~Stronghold~MOD:	Title='Bench <color=yellow>Stronghold</color>', Desc=''
Bench_C~ElvenPalace~MOD:	Title='Bench <color=yellow>Elven Palace</color>', Desc=''
Bench_C~Stronghold~MOD:	Title='Bench <color=yellow>Stronghold</color>', Desc=''
BigColumn_Bottom~TownInterior~MOD:	Title='Column <color=yellow>Town Interiors</color>', Desc=''
Birdcage~ElvenPalace~MOD:	Title='Birdcage <color=yellow>Elven Palace</color>', Desc=''
Birdcage~TownInterior~MOD:	Title='Birdcage <color=yellow>Town Interiors</color>', Desc=''
Bookshelf_A_Covered~Stronghold~MOD:	Title='Bookshelf <color=yellow>Stronghold</color>', Desc=''
Bookshelf_A~ElvenPalace~MOD:	Title='Bookshelf <color=yellow>Elven Palace</color>', Desc=''
Bookshelf_A~Stronghold~MOD:	Title='Bookshelf <color=yellow>Stronghold</color>', Desc=''
Bookshelf_A~TownInterior~MOD:	Title='Bookshelf <color=yellow>Town Interiors</color>', Desc=''
Bookshelf_B_Covered~Stronghold~MOD:	Title='Bookshelf <color=yellow>Stronghold</color>', Desc=''
Bookshelf_B~ElvenPalace~MOD:	Title='Bookshelf <color=yellow>Elven Palace</color>', Desc=''
Bookshelf_B~Stronghold~MOD:	Title='Bookshelf <color=yellow>Stronghold</color>', Desc=''
Bookshelf_B~TownInterior~MOD:	Title='Bookshelf <color=yellow>Town Interiors</color>', Desc=''
Bookshelf_C~ElvenPalace~MOD:	Title='Bookshelf <color=yellow>Elven Palace</color>', Desc=''
Bookshelf_C~Stronghold~MOD:	Title='Bookshelf <color=yellow>Stronghold</color>', Desc=''
Bookshelf_D~ElvenPalace~MOD:	Title='Bookshelf <color=yellow>Elven Palace</color>', Desc=''
Bookshelf_D~Stronghold~MOD:	Title='Bookshelf <color=yellow>Stronghold</color>', Desc=''
Bookshelf_D~TownInterior~MOD:	Title='Bookshelf <color=yellow>Town Interiors</color>', Desc=''
Bookshelf_E~ElvenPalace~MOD:	Title='Bookshelf <color=yellow>Elven Palace</color>', Desc=''
Bookshelf_E~Stronghold~MOD:	Title='Bookshelf <color=yellow>Stronghold</color>', Desc=''
BookStack_A~ElvenPalace~MOD:	Title='Book Stack <color=yellow>Elven Palace</color>', Desc=''
BookStack_A~Stronghold~MOD:	Title='Book Stack <color=yellow>Stronghold</color>', Desc=''
BookStack_A~TownInterior~MOD:	Title='Book Stack <color=yellow>Town Interiors</color>', Desc=''
BookStack_B~ElvenPalace~MOD:	Title='Book Stack <color=yellow>Elven Palace</color>', Desc=''
BookStack_B~Stronghold~MOD:	Title='Book Stack <color=yellow>Stronghold</color>', Desc=''
BookStack_B~TownInterior~MOD:	Title='Book Stack <color=yellow>Town Interiors</color>', Desc=''
BookStack_C~ElvenPalace~MOD:	Title='Book Stack <color=yellow>Elven Palace</color>', Desc=''
BookStack_C~Stronghold~MOD:	Title='Book Stack <color=yellow>Stronghold</color>', Desc=''
BookStack_C~TownInterior~MOD:	Title='Book Stack <color=yellow>Town Interiors</color>', Desc=''
Brasero_A~Catacombs~MOD:	Title='Brazier <color=yellow>Catacombs</color>', Desc=''
Brasero_A~LavaCaves~MOD:	Title='Brazier <color=yellow>Lava Caves</color>', Desc=''
Brasero_B~Catacombs~MOD:	Title='Brazier <color=yellow>Catacombs</color>', Desc=''
Brasero_B~LavaCaves~MOD:	Title='Brazier <color=yellow>Lava Caves</color>', Desc=''
Bridge_A~Catacombs~MOD:	Title='Bridge <color=yellow>Catacombs</color>', Desc=''
Bridge_A~Sewers~MOD:	Title='Bridge <color=yellow>Sewers</color>', Desc=''
Bridge_B~Catacombs~MOD:	Title='Bridge <color=yellow>Catacombs</color>', Desc=''
Bridge_B~Sewers~MOD:	Title='Bridge <color=yellow>Sewers</color>', Desc=''
Bridge_C~Catacombs~MOD:	Title='Bridge <color=yellow>Catacombs</color>', Desc=''
Bridge_C~Sewers~MOD:	Title='Bridge <color=yellow>Sewers</color>', Desc=''
Bridge~Town~MOD:	Title='Bridge <color=yellow>Town</color>', Desc=''
Building_Cabin_12C~WoodLand~MOD:	Title='Small Cabin <color=yellow>Woodland</color>', Desc=''
Building_Lodge_24C~WoodLand~MOD:	Title='Large Lodge <color=yellow>Woodland</color>', Desc=''
BurningDebris_A~Town~MOD:	Title='Burning Debris <color=yellow>Town</color>', Desc=''
BurningDebris_A~WoodLand~MOD:	Title='Burning Debris <color=yellow>Woodland</color>', Desc=''
BurningDebris_B~Town~MOD:	Title='Burning Debris <color=yellow>Town</color>', Desc=''
BurningDebris_B~WoodLand~MOD:	Title='Burning Debris <color=yellow>Woodland</color>', Desc=''
BurningDebris_C~Town~MOD:	Title='Burning Debris <color=yellow>Town</color>', Desc=''
BurningDebris_C~WoodLand~MOD:	Title='Burning Debris <color=yellow>Woodland</color>', Desc=''
BurningDebris_D~Town~MOD:	Title='Burning Debris <color=yellow>Town</color>', Desc=''
BurningDebris_D~WoodLand~MOD:	Title='Burning Debris <color=yellow>Woodland</color>', Desc=''
BurningDebris_E~Town~MOD:	Title='Burning Debris <color=yellow>Town</color>', Desc=''
BurningDebris_E~WoodLand~MOD:	Title='Burning Debris <color=yellow>Woodland</color>', Desc=''
Bushes_A~Town~MOD:	Title='Bushes <color=yellow>Town</color>', Desc=''
Bushes_A~WoodLand~MOD:	Title='Bushes <color=yellow>Woodland</color>', Desc=''
Bushes_B~Town~MOD:	Title='Bushes <color=yellow>Town</color>', Desc=''
Bushes_B~WoodLand~MOD:	Title='Bushes <color=yellow>Woodland</color>', Desc=''
Bushes_C~Town~MOD:	Title='Bushes <color=yellow>Town</color>', Desc=''
Bushes_C~WoodLand~MOD:	Title='Bushes <color=yellow>Woodland</color>', Desc=''
Cabinet_A~ElvenPalace~MOD:	Title='Cabinet <color=yellow>Elven Palace</color>', Desc=''
Cabinet_A~Stronghold~MOD:	Title='Cabinet <color=yellow>Stronghold</color>', Desc=''
Cabinet_A~TownInterior~MOD:	Title='Cabinet <color=yellow>Town Interiors</color>', Desc=''
Cabinet_B~ElvenPalace~MOD:	Title='Cabinet <color=yellow>Elven Palace</color>', Desc=''
Cabinet_B~Stronghold~MOD:	Title='Cabinet <color=yellow>Stronghold</color>', Desc=''
Cabinet_B~TownInterior~MOD:	Title='Cabinet <color=yellow>Town Interiors</color>', Desc=''
Cabinet_C~TownInterior~MOD:	Title='Cabinet <color=yellow>Town Interiors</color>', Desc=''
Cabinet_Covered_A~Stronghold~MOD:	Title='Cabinet <color=yellow>Stronghold</color>', Desc=''
Cabinet_Covered_A~TownInterior~MOD:	Title='Cabinet <color=yellow>Town Interiors</color>', Desc=''
Cabinet_Covered_B~Stronghold~MOD:	Title='Cabinet <color=yellow>Stronghold</color>', Desc=''
Cabinet_Covered_B~TownInterior~MOD:	Title='Cabinet <color=yellow>Town Interiors</color>', Desc=''
Cage_A~LavaCaves~MOD:	Title='Cage <color=yellow>Lava Caves</color>', Desc=''
Cage_A~Sewers~MOD:	Title='Cage <color=yellow>Sewers</color>', Desc=''
Cage_B~LavaCaves~MOD:	Title='Cage <color=yellow>Lava Caves</color>', Desc=''
Cage_B~Sewers~MOD:	Title='Cage <color=yellow>Sewers</color>', Desc=''
Candelabra_A~Catacombs~MOD:	Title='Candelabra <color=yellow>Catacombs</color>', Desc=''
Candelabra_A~ElvenPalace~MOD:	Title='Candelabra <color=yellow>Elven Palace</color>', Desc=''
Candelabra_A~Necropolis~MOD:	Title='Candelabra <color=yellow>Necropolis</color>', Desc=''
Candelabra_A~Stronghold~MOD:	Title='Candelabra <color=yellow>Stronghold</color>', Desc=''
Candelabra_A~TownInterior~MOD:	Title='Candelabra <color=yellow>Town Interiors</color>', Desc=''
Candelabra_Covered_A~Stronghold~MOD:	Title='Candelabra <color=yellow>Stronghold</color>', Desc=''
Caravan_A~Town~MOD:	Title='Caravan <color=yellow>Town</color>', Desc=''
Caravan_A~WoodLand~MOD:	Title='Caravan <color=yellow>Woodland</color>', Desc=''
Caravan_B~Town~MOD:	Title='Caravan <color=yellow>Town</color>', Desc=''
Caravan_B~WoodLand~MOD:	Title='Caravan <color=yellow>Woodland</color>', Desc=''
Carpet_A~ElvenPalace~MOD:	Title='Carpet <color=yellow>Elven Palace</color>', Desc=''
Carpet_A~Stronghold~MOD:	Title='Carpet <color=yellow>Stronghold</color>', Desc=''
Carpet_A~TownInterior~MOD:	Title='Carpet <color=yellow>Town Interiors</color>', Desc=''
Carpet_B~Catacombs~MOD:	Title='Carpet <color=yellow>Catacombs</color>', Desc=''
Carpet_B~ElvenPalace~MOD:	Title='Carpet <color=yellow>Elven Palace</color>', Desc=''
Carpet_B~LavaCaves~MOD:	Title='Carpet <color=yellow>Lava Caves</color>', Desc=''
Carpet_B~Sewers~MOD:	Title='Carpet <color=yellow>Sewers</color>', Desc=''
Carpet_B~Stronghold~MOD:	Title='Carpet <color=yellow>Stronghold</color>', Desc=''
Carpet_B~TownInterior~MOD:	Title='Carpet <color=yellow>Town Interiors</color>', Desc=''
Carpet_B~WoodLand~MOD:	Title='Carpet <color=yellow>Woodland</color>', Desc=''
Carpet_C~Catacombs~MOD:	Title='Carpet <color=yellow>Catacombs</color>', Desc=''
Carpet_C~ElvenPalace~MOD:	Title='Carpet <color=yellow>Elven Palace</color>', Desc=''
Carpet_C~LavaCaves~MOD:	Title='Carpet <color=yellow>Lava Caves</color>', Desc=''
Carpet_C~Sewers~MOD:	Title='Carpet <color=yellow>Sewers</color>', Desc=''
Carpet_C~Stronghold~MOD:	Title='Carpet <color=yellow>Stronghold</color>', Desc=''
Carpet_C~TownInterior~MOD:	Title='Carpet <color=yellow>Town Interiors</color>', Desc=''
Carpet_C~WoodLand~MOD:	Title='Carpet <color=yellow>Woodland</color>', Desc=''
Carpet_D~TownInterior~MOD:	Title='Carpet <color=yellow>Town Interiors</color>', Desc=''
Carpet_E~TownInterior~MOD:	Title='Carpet <color=yellow>Town Interiors</color>', Desc=''
Carpet_F~TownInterior~MOD:	Title='Carpet <color=yellow>Town Interiors</color>', Desc=''
Cart_A~LavaCaves~MOD:	Title='Cart <color=yellow>Lava Caves</color>', Desc=''
Cart_A~Town~MOD:	Title='Cart <color=yellow>Town</color>', Desc=''
Cart_A~WoodLand~MOD:	Title='Cart <color=yellow>Woodland</color>', Desc=''
Cart_B~LavaCaves~MOD:	Title='Cart <color=yellow>Lava Caves</color>', Desc=''
Cart_B~Town~MOD:	Title='Cart <color=yellow>Town</color>', Desc=''
Cart_B~WoodLand~MOD:	Title='Cart <color=yellow>Woodland</color>', Desc=''
Cart_C~Town~MOD:	Title='Cart <color=yellow>Town</color>', Desc=''
Cart_C~WoodLand~MOD:	Title='Cart <color=yellow>Woodland</color>', Desc=''
Castle_Fence_A~WoodLand~MOD:	Title='Castle Wall <color=yellow>Woodland</color>', Desc=''
Castle_Fence_B~WoodLand~MOD:	Title='Castle Wall <color=yellow>Woodland</color>', Desc=''
Castle_Fence_Filler~WoodLand~MOD:	Title='Castle Inner Wall Filler <color=yellow>Woodland</color>', Desc=''
Castle_InnerDoor_A~WoodLand~MOD:	Title='Castle Inner Wall Doorway <color=yellow>Woodland</color>', Desc=''
Castle_InnerDoor_B~WoodLand~MOD:	Title='Castle Inner Wall Doorway <color=yellow>Woodland</color>', Desc=''
Castle_InnerDoor_C~WoodLand~MOD:	Title='Castle Inner Wall Doorway <color=yellow>Woodland</color>', Desc=''
Castle_InnerObstacle_A~WoodLand~MOD:	Title='Castle Inner Wall Obstacle <color=yellow>Woodland</color>', Desc=''
Castle_InnerObstacle_B~WoodLand~MOD:	Title='Castle Inner Wall Obstacle <color=yellow>Woodland</color>', Desc=''
Castle_InnerObstacle_C~WoodLand~MOD:	Title='Castle Inner Wall Obstacle <color=yellow>Woodland</color>', Desc=''
Castle_InnerObstacle_D~WoodLand~MOD:	Title='Castle Inner Wall Obstacle <color=yellow>Woodland</color>', Desc=''
Castle_InnerWall_A~WoodLand~MOD:	Title='Castle Inner Wall <color=yellow>Woodland</color>', Desc=''
Castle_InnerWall_B~WoodLand~MOD:	Title='Castle Inner Wall <color=yellow>Woodland</color>', Desc=''
Castle_InnerWall_C~WoodLand~MOD:	Title='Castle Inner Wall <color=yellow>Woodland</color>', Desc=''
Castle_InnerWall_D~WoodLand~MOD:	Title='Castle Inner Wall <color=yellow>Woodland</color>', Desc=''
Castle_InnerWall_E~WoodLand~MOD:	Title='Castle Inner Wall <color=yellow>Woodland</color>', Desc=''
Castle_InnerWall_F~WoodLand~MOD:	Title='Castle Inner Wall <color=yellow>Woodland</color>', Desc=''
Castle_InnerWall_Filler~WoodLand~MOD:	Title='Castle Inner Wall Filler <color=yellow>Woodland</color>', Desc=''
Castle_InnerWall_G~WoodLand~MOD:	Title='Castle Inner Wall <color=yellow>Woodland</color>', Desc=''
Castle_InnerWall_H~WoodLand~MOD:	Title='Castle Inner Wall <color=yellow>Woodland</color>', Desc=''
Castle_InnerWall_I~WoodLand~MOD:	Title='Castle Inner Wall <color=yellow>Woodland</color>', Desc=''
Castle_InnerWall_J~WoodLand~MOD:	Title='Castle Inner Wall <color=yellow>Woodland</color>', Desc=''
Castle_InnerWall_K~WoodLand~MOD:	Title='Castle Inner Wall <color=yellow>Woodland</color>', Desc=''
Castle_InnerWall_L~WoodLand~MOD:	Title='Castle Inner Wall <color=yellow>Woodland</color>', Desc=''
Castle_InnerWall_M~WoodLand~MOD:	Title='Castle Inner Wall <color=yellow>Woodland</color>', Desc=''
Castle_Ladder~WoodLand~MOD:	Title='Ladder <color=yellow>Woodland</color>', Desc=''
Castle_LadderSmall~WoodLand~MOD:	Title='Ladder <color=yellow>Woodland</color>', Desc=''
Castle_Scaffolding~WoodLand~MOD:	Title='Scaffoldings <color=yellow>Woodland</color>', Desc=''
Castle_Tower_A~WoodLand~MOD:	Title='Castle Tower <color=yellow>Woodland</color>', Desc=''
Castle_Tower_B~WoodLand~MOD:	Title='Castle Tower <color=yellow>Woodland</color>', Desc=''
Castle_Tower_C~WoodLand~MOD:	Title='Castle Tower <color=yellow>Woodland</color>', Desc=''
Castle_Tower_D~WoodLand~MOD:	Title='Castle Tower <color=yellow>Woodland</color>', Desc=''
Castle_Tower_E~WoodLand~MOD:	Title='Castle Tower <color=yellow>Woodland</color>', Desc=''
Castle_Tower_F~WoodLand~MOD:	Title='Castle Tower <color=yellow>Woodland</color>', Desc=''
Castle_Wall_A~WoodLand~MOD:	Title='Castle Wall <color=yellow>Woodland</color>', Desc=''
Castle_Wall_B~WoodLand~MOD:	Title='Castle Wall <color=yellow>Woodland</color>', Desc=''
Castle_Wall_C~WoodLand~MOD:	Title='Castle Wall <color=yellow>Woodland</color>', Desc=''
Castle_Wall_D~WoodLand~MOD:	Title='Castle Wall <color=yellow>Woodland</color>', Desc=''
CaveEntrance_A~WoodLand~MOD:	Title='Cave entrance <color=yellow>Woodland</color>', Desc=''
CaveEntrance_B~WoodLand~MOD:	Title='Cave entrance <color=yellow>Woodland</color>', Desc=''
Caves_InnerDoor_A~LavaCaves~MOD:	Title='Free Wall - Doorway <color=yellow>Lava Caves</color>', Desc=''
Cell_A~Sewers~MOD:	Title='Cell <color=yellow>Sewers</color>', Desc=''
Cell_B~Sewers~MOD:	Title='Cell <color=yellow>Sewers</color>', Desc=''
Cemetery_Pilar~Town~MOD:	Title='Low Wall <color=yellow>Town</color>', Desc=''
Cemetery_Wall_A~Town~MOD:	Title='Low Wall <color=yellow>Town</color>', Desc=''
Cemetery_Wall_B~Town~MOD:	Title='Low Wall <color=yellow>Town</color>', Desc=''
Cemetery_Wall_C~Town~MOD:	Title='Low Wall <color=yellow>Town</color>', Desc=''
Cemetery_Wall_D~Town~MOD:	Title='Low Wall <color=yellow>Town</color>', Desc=''
Chain_A~ElvenPalace~MOD:	Title='Chain <color=yellow>Elven Palace</color>', Desc=''
Chain_A~Necropolis~MOD:	Title='Chain <color=yellow>Necropolis</color>', Desc=''
Chain_A~Stronghold~MOD:	Title='Chain <color=yellow>Stronghold</color>', Desc=''
Chain_B~ElvenPalace~MOD:	Title='Chain <color=yellow>Elven Palace</color>', Desc=''
Chain_B~Necropolis~MOD:	Title='Chain <color=yellow>Necropolis</color>', Desc=''
Chain_B~Stronghold~MOD:	Title='Chain <color=yellow>Stronghold</color>', Desc=''
Chair_A~Catacombs~MOD:	Title='Chair <color=yellow>Catacombs</color>', Desc=''
Chair_A~ElvenPalace~MOD:	Title='Chair <color=yellow>Elven Palace</color>', Desc=''
Chair_A~Sewers~MOD:	Title='Chair <color=yellow>Sewers</color>', Desc=''
Chair_A~Stronghold~MOD:	Title='Chair <color=yellow>Stronghold</color>', Desc=''
Chair_A~WoodLand~MOD:	Title='Chair <color=yellow>Woodland</color>', Desc=''
Chair_B_Covered~Sewers~MOD:	Title='Chair <color=yellow>Sewers</color>', Desc=''
Chair_B_Covered~Stronghold~MOD:	Title='Chair <color=yellow>Stronghold</color>', Desc=''
Chair_B~ElvenPalace~MOD:	Title='Chair <color=yellow>Elven Palace</color>', Desc=''
Chair_B~Stronghold~MOD:	Title='Chair <color=yellow>Stronghold</color>', Desc=''
ChairTavern_A~TownInterior~MOD:	Title='Chair <color=yellow>Town Interiors</color>', Desc=''
Clearing_Large_24C~WoodLand~MOD:	Title='Large Clearing <color=yellow>Woodland</color>', Desc=''
Clearing_Small_12C~Jungle~MOD:	Title='Small Clearing <color=yellow>Jungle</color>', Desc=''
Clearing_Small_12C~WoodLand~MOD:	Title='Small Clearing <color=yellow>Woodland</color>', Desc=''
Cocoon_A~Catacombs~MOD:	Title='Cocoon <color=yellow>Catacombs</color>', Desc=''
Cocoon_A~LavaCaves~MOD:	Title='Cocoon <color=yellow>Lava Caves</color>', Desc=''
Cocoon_B~Catacombs~MOD:	Title='Cocoon <color=yellow>Catacombs</color>', Desc=''
Cocoon_B~LavaCaves~MOD:	Title='Cocoon <color=yellow>Lava Caves</color>', Desc=''
Column_B~Catacombs~MOD:	Title='Column B <color=yellow>Catacombs</color>', Desc=''
Column_B~ElvenPalace~MOD:	Title='Column B <color=yellow>Elven Palace</color>', Desc=''
Column_B~Necropolis~MOD:	Title='Column B <color=yellow>Necropolis</color>', Desc=''
Column_B~Stronghold~MOD:	Title='Column B <color=yellow>Stronghold</color>', Desc=''
Column_C~Catacombs~MOD:	Title='Column B <color=yellow>Catacombs</color>', Desc=''
Column_C~ElvenPalace~MOD:	Title='Column B <color=yellow>Elven Palace</color>', Desc=''
Column_D~Catacombs~MOD:	Title='Column <color=yellow>Catacombs</color>', Desc=''
Column_Pennant~Town~MOD:	Title='Pennant <color=yellow>Town</color>', Desc=''
CookingStuff_A~WoodLand~MOD:	Title='Cooking pot <color=yellow>Woodland</color>', Desc=''
Corner_12C~Catacombs~MOD:	Title='Corner <color=yellow>Catacombs</color>', Desc=''
Corner_12C~ElvenPalace~MOD:	Title='Corner <color=yellow>Elven Palace</color>', Desc=''
Corner_12C~Necropolis~MOD:	Title='Corner <color=yellow>Necropolis</color>', Desc=''
Corner_12C~Sewers~MOD:	Title='Corner <color=yellow>Sewers</color>', Desc=''
Corner_12C~Stronghold~MOD:	Title='Corner <color=yellow>Stronghold</color>', Desc=''
Corpse_A~Catacombs~MOD:	Title='Corpse <color=yellow>Catacombs</color>', Desc=''
Corpse_A~LavaCaves~MOD:	Title='Corpse <color=yellow>Lava Caves</color>', Desc=''
Corpse_A~Necropolis~MOD:	Title='Corpse <color=yellow>Necropolis</color>', Desc=''
Corpse_A~Sewers~MOD:	Title='Corpse <color=yellow>Sewers</color>', Desc=''
Corpse_A~Stronghold~MOD:	Title='Corpse <color=yellow>Stronghold</color>', Desc=''
Corpse_A~Town~MOD:	Title='Corpse <color=yellow>Town</color>', Desc=''
Corpse_A~TownInterior~MOD:	Title='Corpse <color=yellow>Town Interiors</color>', Desc=''
Corpse_A~WoodLand~MOD:	Title='Corpse <color=yellow>Woodland</color>', Desc=''
Corpse_B~Catacombs~MOD:	Title='Corpse <color=yellow>Catacombs</color>', Desc=''
Corpse_B~LavaCaves~MOD:	Title='Corpse <color=yellow>Lava Caves</color>', Desc=''
Corpse_B~Necropolis~MOD:	Title='Corpse <color=yellow>Necropolis</color>', Desc=''
Corpse_B~Sewers~MOD:	Title='Corpse <color=yellow>Sewers</color>', Desc=''
Corpse_B~Stronghold~MOD:	Title='Corpse <color=yellow>Stronghold</color>', Desc=''
Corpse_B~Town~MOD:	Title='Corpse <color=yellow>Town</color>', Desc=''
Corpse_B~TownInterior~MOD:	Title='Corpse <color=yellow>Town Interiors</color>', Desc=''
Corpse_B~WoodLand~MOD:	Title='Corpse <color=yellow>Woodland</color>', Desc=''
Corpse_C~LavaCaves~MOD:	Title='Corpse <color=yellow>Lava Caves</color>', Desc=''
Corpse_Pile_A~Catacombs~MOD:	Title='Corpse <color=yellow>Catacombs</color>', Desc=''
Corpse_Pile_A~ElvenPalace~MOD:	Title='Corpse <color=yellow>Elven Palace</color>', Desc=''
Corpse_Pile_A~LavaCaves~MOD:	Title='Corpse <color=yellow>Lava Caves</color>', Desc=''
Corpse_Pile_A~Necropolis~MOD:	Title='Corpse <color=yellow>Necropolis</color>', Desc=''
Corpse_Pile_A~Sewers~MOD:	Title='Corpse <color=yellow>Sewers</color>', Desc=''
Corpse_Pile_A~Stronghold~MOD:	Title='Corpse <color=yellow>Stronghold</color>', Desc=''
Corpse_Pile_A~Town~MOD:	Title='Corpse <color=yellow>Town</color>', Desc=''
Corpse_Pile_A~TownInterior~MOD:	Title='Corpse <color=yellow>Town Interiors</color>', Desc=''
Corpse_Pile_A~WoodLand~MOD:	Title='Corpse <color=yellow>Woodland</color>', Desc=''
Couch_A~ElvenPalace~MOD:	Title='Couch <color=yellow>Elven Palace</color>', Desc=''
Couch_B~ElvenPalace~MOD:	Title='Couch <color=yellow>Elven Palace</color>', Desc=''
Couch_C~ElvenPalace~MOD:	Title='Couch <color=yellow>Elven Palace</color>', Desc=''
Couch_Corner_A~ElvenPalace~MOD:	Title='Couch <color=yellow>Elven Palace</color>', Desc=''
Couch_Corner_B~ElvenPalace~MOD:	Title='Couch <color=yellow>Elven Palace</color>', Desc=''
Crate_A~Catacombs~MOD:	Title='Crate <color=yellow>Catacombs</color>', Desc=''
Crate_A~ElvenPalace~MOD:	Title='Crate <color=yellow>Elven Palace</color>', Desc=''
Crate_A~LavaCaves~MOD:	Title='Crate <color=yellow>Lava Caves</color>', Desc=''
Crate_A~Sewers~MOD:	Title='Crate <color=yellow>Sewers</color>', Desc=''
Crate_A~Stronghold~MOD:	Title='Crate <color=yellow>Stronghold</color>', Desc=''
Crate_A~Town~MOD:	Title='Crate <color=yellow>Town</color>', Desc=''
Crate_A~WoodLand~MOD:	Title='Crate <color=yellow>Woodland</color>', Desc=''
Crate_B~Catacombs~MOD:	Title='Crate <color=yellow>Catacombs</color>', Desc=''
Crate_B~LavaCaves~MOD:	Title='Crate <color=yellow>Lava Caves</color>', Desc=''
Crate_B~Sewers~MOD:	Title='Crate <color=yellow>Sewers</color>', Desc=''
Crate_B~Stronghold~MOD:	Title='Crate <color=yellow>Stronghold</color>', Desc=''
Crate_B~Town~MOD:	Title='Crate <color=yellow>Town</color>', Desc=''
Crate_B~WoodLand~MOD:	Title='Crate <color=yellow>Woodland</color>', Desc=''
Crate_C~Catacombs~MOD:	Title='Crate <color=yellow>Catacombs</color>', Desc=''
Crate_C~LavaCaves~MOD:	Title='Crate <color=yellow>Lava Caves</color>', Desc=''
Crate_C~Sewers~MOD:	Title='Crate <color=yellow>Sewers</color>', Desc=''
Crate_C~Town~MOD:	Title='Crate <color=yellow>Town</color>', Desc=''
Crate_C~WoodLand~MOD:	Title='Crate <color=yellow>Woodland</color>', Desc=''
CrateStack_A~Catacombs~MOD:	Title='Crate Stack <color=yellow>Catacombs</color>', Desc=''
CrateStack_A~ElvenPalace~MOD:	Title='Crate Stack <color=yellow>Elven Palace</color>', Desc=''
CrateStack_A~LavaCaves~MOD:	Title='Crate Stack <color=yellow>Lava Caves</color>', Desc=''
CrateStack_A~Sewers~MOD:	Title='Crate Stack <color=yellow>Sewers</color>', Desc=''
CrateStack_A~Stronghold~MOD:	Title='Crate Stack <color=yellow>Stronghold</color>', Desc=''
CrateStack_A~Town~MOD:	Title='Crate Stack <color=yellow>Town</color>', Desc=''
CrateStack_A~TownInterior~MOD:	Title='Crate Stack <color=yellow>Town Interiors</color>', Desc=''
CrateStack_A~WoodLand~MOD:	Title='Crate Stack <color=yellow>Woodland</color>', Desc=''
CrateStack_B~Catacombs~MOD:	Title='Crate Stack <color=yellow>Catacombs</color>', Desc=''
CrateStack_B~LavaCaves~MOD:	Title='Crate Stack <color=yellow>Lava Caves</color>', Desc=''
CrateStack_B~Sewers~MOD:	Title='Crate Stack <color=yellow>Sewers</color>', Desc=''
CrateStack_B~Stronghold~MOD:	Title='Crate Stack <color=yellow>Stronghold</color>', Desc=''
CrateStack_B~Town~MOD:	Title='Crate Stack <color=yellow>Town</color>', Desc=''
CrateStack_B~TownInterior~MOD:	Title='Crate Stack <color=yellow>Town Interiors</color>', Desc=''
CrateStack_B~WoodLand~MOD:	Title='Crate Stack <color=yellow>Woodland</color>', Desc=''
Creeper_A~Sewers~MOD:	Title='Creeper/Ivy <color=yellow>Sewers</color>', Desc=''
Creeper_B~Sewers~MOD:	Title='Creeper/Ivy <color=yellow>Sewers</color>', Desc=''
Creeper_C~Sewers~MOD:	Title='Creeper/Ivy <color=yellow>Sewers</color>', Desc=''
Crossroad_12C_Organic~LavaCaves~MOD:	Title='Crossroad <color=yellow>Lava Caves</color>', Desc=''
Crossroad_12C~Catacombs~MOD:	Title='Crossroad <color=yellow>Catacombs</color>', Desc=''
Crossroad_12C~ElvenPalace~MOD:	Title='Crossroad <color=yellow>Elven Palace</color>', Desc=''
Crossroad_12C~Necropolis~MOD:	Title='Crossroad <color=yellow>Necropolis</color>', Desc=''
Crossroad_12C~Sewers~MOD:	Title='Crossroad <color=yellow>Sewers</color>', Desc=''
Crossroad_12C~Stronghold~MOD:	Title='Crossroad <color=yellow>Stronghold</color>', Desc=''
Curve_12C~Catacombs~MOD:	Title='Small curved room <color=yellow>Catacombs</color>', Desc=''
Curve_24C~Catacombs~MOD:	Title='Big curved room <color=yellow>Catacombs</color>', Desc=''
Curve_U_24C~Catacombs~MOD:	Title='Big curved room <color=yellow>Catacombs</color>', Desc=''
Cushions_A~ElvenPalace~MOD:	Title='Cushions <color=yellow>Elven Palace</color>', Desc=''
Cushions_A~TownInterior~MOD:	Title='Cushions <color=yellow>Town Interiors</color>', Desc=''
Cushions_B~ElvenPalace~MOD:	Title='Cushions <color=yellow>Elven Palace</color>', Desc=''
Cushions_B~TownInterior~MOD:	Title='Cushions <color=yellow>Town Interiors</color>', Desc=''
Dam_A~Sewers~MOD:	Title='Free Wall <color=yellow>Sewers</color>', Desc=''
Decorative_House_B~Town~MOD:	Title='Market <color=yellow>Town</color>', Desc=''
Desk_A~ElvenPalace~MOD:	Title='Desk <color=yellow>Elven Palace</color>', Desc=''
DestroyedStuff_A~Catacombs~MOD:	Title='Broken Furnitures <color=yellow>Catacombs</color>', Desc=''
DestroyedStuff_A~LavaCaves~MOD:	Title='Broken Furnitures <color=yellow>Lava Caves</color>', Desc=''
DestroyedStuff_A~Sewers~MOD:	Title='Broken Furnitures <color=yellow>Sewers</color>', Desc=''
DestroyedStuff_A~Stronghold~MOD:	Title='Broken Furnitures <color=yellow>Stronghold</color>', Desc=''
DestroyedStuff_A~TownInterior~MOD:	Title='Broken Furnitures <color=yellow>Town Interiors</color>', Desc=''
DestroyedStuff_B~Catacombs~MOD:	Title='Broken Furnitures <color=yellow>Catacombs</color>', Desc=''
DestroyedStuff_B~LavaCaves~MOD:	Title='Broken Furnitures <color=yellow>Lava Caves</color>', Desc=''
DestroyedStuff_B~Sewers~MOD:	Title='Broken Furnitures <color=yellow>Sewers</color>', Desc=''
DestroyedStuff_B~Stronghold~MOD:	Title='Broken Furnitures <color=yellow>Stronghold</color>', Desc=''
DestroyedStuff_B~TownInterior~MOD:	Title='Broken Furnitures <color=yellow>Town Interiors</color>', Desc=''
DestroyedStuff_C~Catacombs~MOD:	Title='Broken Furnitures <color=yellow>Catacombs</color>', Desc=''
DestroyedStuff_C~LavaCaves~MOD:	Title='Broken Furnitures <color=yellow>Lava Caves</color>', Desc=''
DestroyedStuff_C~Sewers~MOD:	Title='Broken Furnitures <color=yellow>Sewers</color>', Desc=''
DestroyedStuff_C~Stronghold~MOD:	Title='Broken Furnitures <color=yellow>Stronghold</color>', Desc=''
DestroyedStuff_C~TownInterior~MOD:	Title='Broken Furnitures <color=yellow>Town Interiors</color>', Desc=''
DestroyedStuff_D~Catacombs~MOD:	Title='Broken Furnitures <color=yellow>Catacombs</color>', Desc=''
DestroyedStuff_D~LavaCaves~MOD:	Title='Broken Furnitures <color=yellow>Lava Caves</color>', Desc=''
DestroyedStuff_D~Sewers~MOD:	Title='Broken Furnitures <color=yellow>Sewers</color>', Desc=''
DestroyedStuff_D~Stronghold~MOD:	Title='Broken Furnitures <color=yellow>Stronghold</color>', Desc=''
DestroyedStuff_D~TownInterior~MOD:	Title='Broken Furnitures <color=yellow>Town Interiors</color>', Desc=''
DestroyedStuff_E~Catacombs~MOD:	Title='Broken Furnitures <color=yellow>Catacombs</color>', Desc=''
DestroyedStuff_E~LavaCaves~MOD:	Title='Broken Furnitures <color=yellow>Lava Caves</color>', Desc=''
DestroyedStuff_E~Sewers~MOD:	Title='Broken Furnitures <color=yellow>Sewers</color>', Desc=''
DestroyedStuff_E~Stronghold~MOD:	Title='Broken Furnitures <color=yellow>Stronghold</color>', Desc=''
DestroyedStuff_E~TownInterior~MOD:	Title='Broken Furnitures <color=yellow>Town Interiors</color>', Desc=''
DestroyedStuff_F~ElvenPalace~MOD:	Title='Broken Furnitures <color=yellow>Elven Palace</color>', Desc=''
DestroyedStuff_F~TownInterior~MOD:	Title='Broken Furnitures <color=yellow>Town Interiors</color>', Desc=''
DestroyedStuff_G~ElvenPalace~MOD:	Title='Broken Furnitures <color=yellow>Elven Palace</color>', Desc=''
DestroyedStuff_G~TownInterior~MOD:	Title='Broken Furnitures <color=yellow>Town Interiors</color>', Desc=''
DestroyedStuff_H~ElvenPalace~MOD:	Title='Broken Furnitures <color=yellow>Elven Palace</color>', Desc=''
DestroyedStuff_H~TownInterior~MOD:	Title='Broken Furnitures <color=yellow>Town Interiors</color>', Desc=''
DestroyedStuff_I~ElvenPalace~MOD:	Title='Broken Furnitures <color=yellow>Elven Palace</color>', Desc=''
DestroyedStuff_I~TownInterior~MOD:	Title='Broken Furnitures <color=yellow>Town Interiors</color>', Desc=''
DestroyedStuff_J~ElvenPalace~MOD:	Title='Broken Furnitures <color=yellow>Elven Palace</color>', Desc=''
DestroyedStuff_J~TownInterior~MOD:	Title='Broken Furnitures <color=yellow>Town Interiors</color>', Desc=''
DestroyedStuff_K~ElvenPalace~MOD:	Title='Broken Furnitures <color=yellow>Elven Palace</color>', Desc=''
DestroyedStuff_K~Stronghold~MOD:	Title='Broken Furnitures <color=yellow>Stronghold</color>', Desc=''
DestroyedStuff_K~TownInterior~MOD:	Title='Broken Furnitures <color=yellow>Town Interiors</color>', Desc=''
DestroyedStuff_L~Stronghold~MOD:	Title='Broken Furnitures <color=yellow>Stronghold</color>', Desc=''
DestroyedStuff_L~TownInterior~MOD:	Title='Broken Furnitures <color=yellow>Town Interiors</color>', Desc=''
DestroyedStuff_L~WoodLand~MOD:	Title='Broken Furnitures <color=yellow>Woodland</color>', Desc=''
Drain_A~Sewers~MOD:	Title='Drain grate <color=yellow>Sewers</color>', Desc=''
Drain_B~Sewers~MOD:	Title='Drain grate <color=yellow>Sewers</color>', Desc=''
Drain_Big_24C_A~Sewers~MOD:	Title='Big Room <color=yellow>Sewers</color>', Desc=''
Drain_Big_24C_B~Sewers~MOD:	Title='Big Room <color=yellow>Sewers</color>', Desc=''
Drain_C~Sewers~MOD:	Title='Drain grate <color=yellow>Sewers</color>', Desc=''
Drain_Corner_12C~Sewers~MOD:	Title='Corner <color=yellow>Sewers</color>', Desc=''
Drain_Crossroad_12C~Sewers~MOD:	Title='Crossroad <color=yellow>Sewers</color>', Desc=''
Drain_Line_12C~Sewers~MOD:	Title='Line <color=yellow>Sewers</color>', Desc=''
Drain_Line_24C~Sewers~MOD:	Title='Corridor <color=yellow>Sewers</color>', Desc=''
Drain_Small_24C~Sewers~MOD:	Title='Small Room <color=yellow>Sewers</color>', Desc=''
Drain_Turn_12C~Sewers~MOD:	Title='Turn <color=yellow>Sewers</color>', Desc=''
DrainGrate_A~Sewers~MOD:	Title='Drain grate <color=yellow>Sewers</color>', Desc=''
DrainGrate_A~WoodLand~MOD:	Title='Drain grate <color=yellow>Woodland</color>', Desc=''
DrainGrate_B~Sewers~MOD:	Title='Drain grate <color=yellow>Sewers</color>', Desc=''
Drying_Clothes_A~Town~MOD:	Title='Hanging Clothes <color=yellow>Town</color>', Desc=''
Drying_Clothes_A~TownInterior~MOD:	Title='Hanging Clothes <color=yellow>Town Interiors</color>', Desc=''
ElvenPalace~Town~MOD:	Title='Elven Palace <color=yellow>Town</color>', Desc=''
Faction_Banner_A~Town~MOD:	Title='Banner <color=yellow>Town</color>', Desc=''
Faction_Banner_A~TownInterior~MOD:	Title='Banner <color=yellow>Town Interiors</color>', Desc=''
Faction_Banner_B~Town~MOD:	Title='Banner <color=yellow>Town</color>', Desc=''
Faction_Banner_B~TownInterior~MOD:	Title='Banner <color=yellow>Town Interiors</color>', Desc=''
Faction_Banner_C~Town~MOD:	Title='Banner <color=yellow>Town</color>', Desc=''
Faction_Banner_C~TownInterior~MOD:	Title='Banner <color=yellow>Town Interiors</color>', Desc=''
Faction_Banner_D~Town~MOD:	Title='Banner <color=yellow>Town</color>', Desc=''
Faction_Banner_D~TownInterior~MOD:	Title='Banner <color=yellow>Town Interiors</color>', Desc=''
Faction_Banner_E~Town~MOD:	Title='Banner <color=yellow>Town</color>', Desc=''
Faction_Banner_E~TownInterior~MOD:	Title='Banner <color=yellow>Town Interiors</color>', Desc=''
Faction_Banner_F~Town~MOD:	Title='Banner <color=yellow>Town</color>', Desc=''
Faction_Banner_F~TownInterior~MOD:	Title='Banner <color=yellow>Town Interiors</color>', Desc=''
Faction_Banner_G~Town~MOD:	Title='Banner <color=yellow>Town</color>', Desc=''
Faction_Banner_G~TownInterior~MOD:	Title='Banner <color=yellow>Town Interiors</color>', Desc=''
Faction_Banner_H~Town~MOD:	Title='Banner <color=yellow>Town</color>', Desc=''
Faction_Banner_H~TownInterior~MOD:	Title='Banner <color=yellow>Town Interiors</color>', Desc=''
Fence_A~Town~MOD:	Title='Wood Fences <color=yellow>Town</color>', Desc=''
Fence_B~Town~MOD:	Title='Wood Fences <color=yellow>Town</color>', Desc=''
Fence_Post~Town~MOD:	Title='Wood Fences <color=yellow>Town</color>', Desc=''
FireBasin_A~Catacombs~MOD:	Title='Fire Basin <color=yellow>Catacombs</color>', Desc=''
FireBasin_A~LavaCaves~MOD:	Title='Fire Basin <color=yellow>Lava Caves</color>', Desc=''
FireBasin_A~Necropolis~MOD:	Title='Fire Basin <color=yellow>Necropolis</color>', Desc=''
FireBasin_B~Necropolis~MOD:	Title='Fire Basin <color=yellow>Necropolis</color>', Desc=''
Fireplace~Stronghold~MOD:	Title='Fireplace <color=yellow>Stronghold</color>', Desc=''
FireplaceTavern~TownInterior~MOD:	Title='Fireplace <color=yellow>Town Interiors</color>', Desc=''
FlagTavern~TownInterior~MOD:	Title='Banner <color=yellow>Town Interiors</color>', Desc=''
Fountain_A~Town~MOD:	Title='Fountain <color=yellow>Town</color>', Desc=''
Fountain_B~Town~MOD:	Title='Fountain <color=yellow>Town</color>', Desc=''
Gallow~Town~MOD:	Title='Gallow <color=yellow>Town</color>', Desc=''
Garden_Arch~Town~MOD:	Title='Arch <color=yellow>Town</color>', Desc=''
Garden_Flowerbed_Corner_A~Town~MOD:	Title='Flower Bush <color=yellow>Town</color>', Desc=''
Garden_Flowerbed_Line_A~Town~MOD:	Title='Flowerbed Line <color=yellow>Town</color>', Desc=''
Garden_Ground_A~Town~MOD:	Title='Garden Ground <color=yellow>Town</color>', Desc=''
Garden_Hedge_Corner~Town~MOD:	Title='Garden Hedge <color=yellow>Town</color>', Desc=''
Garden_Kiosk~Town~MOD:	Title='Garden Kiosk <color=yellow>Town</color>', Desc=''
Garden_Square_Statue~Town~MOD:	Title='Statue <color=yellow>Town</color>', Desc=''
Garden_Stone_Bench~Town~MOD:	Title='Bench <color=yellow>Town</color>', Desc=''
Garden_Wall_End~Town~MOD:	Title='Free Wall <color=yellow>Town</color>', Desc=''
Garden_Wall_Juniper_B~Town~MOD:	Title='Wall Creeper <color=yellow>Town</color>', Desc=''
Garden_Wall~Town~MOD:	Title='Free Wall <color=yellow>Town</color>', Desc=''
Globe~ElvenPalace~MOD:	Title='Globe <color=yellow>Elven Palace</color>', Desc=''
Greenhouse_A~ElvenPalace~MOD:	Title='Greenhouse <color=yellow>Elven Palace</color>', Desc=''
Greenhouse_B~ElvenPalace~MOD:	Title='Greenhouse <color=yellow>Elven Palace</color>', Desc=''
Greenhouse_C~ElvenPalace~MOD:	Title='Greenhouse <color=yellow>Elven Palace</color>', Desc=''
Harp~ElvenPalace~MOD:	Title='Harp <color=yellow>Elven Palace</color>', Desc=''
HayStack_A~Town~MOD:	Title='Haystack <color=yellow>Town</color>', Desc=''
HayStack_A~WoodLand~MOD:	Title='Haystack <color=yellow>Woodland</color>', Desc=''
HayStack_B~Town~MOD:	Title='Haystack <color=yellow>Town</color>', Desc=''
HayStack_B~WoodLand~MOD:	Title='Haystack <color=yellow>Woodland</color>', Desc=''
House_A~Town~MOD:	Title='House <color=yellow>Town</color>', Desc=''
House_B~Town~MOD:	Title='House <color=yellow>Town</color>', Desc=''
House_C~Town~MOD:	Title='House <color=yellow>Town</color>', Desc=''
House_D~Town~MOD:	Title='House <color=yellow>Town</color>', Desc=''
House_E~Town~MOD:	Title='House <color=yellow>Town</color>', Desc=''
House_F~Town~MOD:	Title='House <color=yellow>Town</color>', Desc=''
House_G~Town~MOD:	Title='House <color=yellow>Town</color>', Desc=''
House_H~Town~MOD:	Title='House <color=yellow>Town</color>', Desc=''
Hut~LavaCaves~MOD:	Title='Hut <color=yellow>Lava Caves</color>', Desc=''
Information_Board_A~Town~MOD:	Title='Information Board <color=yellow>Town</color>', Desc=''
Information_Board_B~Town~MOD:	Title='Information Board <color=yellow>Town</color>', Desc=''
IntWall_A~TownInterior~MOD:	Title='Free Wall <color=yellow>Town Interiors</color>', Desc=''
IntWall_B~TownInterior~MOD:	Title='Free Wall <color=yellow>Town Interiors</color>', Desc=''
IntWall_C~TownInterior~MOD:	Title='Free Wall <color=yellow>Town Interiors</color>', Desc=''
IntWall_Crawl~TownInterior~MOD:	Title='Wall with Crawl Hole <color=yellow>Town Interiors</color>', Desc=''
IntWall_D~TownInterior~MOD:	Title='Free Wall <color=yellow>Town Interiors</color>', Desc=''
IntWall_Thin_A~TownInterior~MOD:	Title='Thin Wall <color=yellow>Town Interiors</color>', Desc=''
IntWall_Thin_A2~TownInterior~MOD:	Title='Thin Wall <color=yellow>Town Interiors</color>', Desc=''
IntWall_Thin_B~TownInterior~MOD:	Title='Thin Wall <color=yellow>Town Interiors</color>', Desc=''
IntWall_Thin_B2~TownInterior~MOD:	Title='Thin Wall <color=yellow>Town Interiors</color>', Desc=''
IntWall_Thin_C~TownInterior~MOD:	Title='Thin Wall <color=yellow>Town Interiors</color>', Desc=''
IntWall_Thin_C2~TownInterior~MOD:	Title='Thin Wall <color=yellow>Town Interiors</color>', Desc=''
IntWall_Thin_Door~TownInterior~MOD:	Title='Thin Wall <color=yellow>Town Interiors</color>', Desc=''
IntWall_Thin_Separator~TownInterior~MOD:	Title='Thin Wall <color=yellow>Town Interiors</color>', Desc=''
IntWall_ThinCracked_A~TownInterior~MOD:	Title='Wall with Crawl Hole <color=yellow>Town Interiors</color>', Desc=''
IntWall_ThinCracked_A2~TownInterior~MOD:	Title='Wall with Crawl Hole <color=yellow>Town Interiors</color>', Desc=''
IntWall_ThinCracked_B~TownInterior~MOD:	Title='Wall with Crawl Hole <color=yellow>Town Interiors</color>', Desc=''
IntWall_ThinCracked_B2~TownInterior~MOD:	Title='Wall with Crawl Hole <color=yellow>Town Interiors</color>', Desc=''
JuniperGround_A~Town~MOD:	Title='Juniper Ground Patch <color=yellow>Town</color>', Desc=''
Ladder~Sewers~MOD:	Title='Ladder <color=yellow>Sewers</color>', Desc=''
LavaBasin_A~LavaCaves~MOD:	Title='Lava Basin <color=yellow>Lava Caves</color>', Desc=''
LavaBasin_B~LavaCaves~MOD:	Title='Lava Basin <color=yellow>Lava Caves</color>', Desc=''
LavaBasin_C~LavaCaves~MOD:	Title='Lava Basin <color=yellow>Lava Caves</color>', Desc=''
Line_12C~Catacombs~MOD:	Title='Line <color=yellow>Catacombs</color>', Desc=''
Line_12C~ElvenPalace~MOD:	Title='Line <color=yellow>Elven Palace</color>', Desc=''
Line_12C~Necropolis~MOD:	Title='Line <color=yellow>Necropolis</color>', Desc=''
Line_12C~Sewers~MOD:	Title='Line <color=yellow>Sewers</color>', Desc=''
Line_12C~Stronghold~MOD:	Title='Line <color=yellow>Stronghold</color>', Desc=''
Line_24C~ElvenPalace~MOD:	Title='Corridor <color=yellow>Elven Palace</color>', Desc=''
Line_24C~Necropolis~MOD:	Title='Corridor <color=yellow>Necropolis</color>', Desc=''
Line_24C~Sewers~MOD:	Title='Corridor <color=yellow>Sewers</color>', Desc=''
Line_24C~Stronghold~MOD:	Title='Corridor <color=yellow>Stronghold</color>', Desc=''
Lodge_A~WoodLand~MOD:	Title='Hut <color=yellow>Woodland</color>', Desc=''
Lodge_B~WoodLand~MOD:	Title='Hut <color=yellow>Woodland</color>', Desc=''
Logs_A~WoodLand~MOD:	Title='Wood logs <color=yellow>Woodland</color>', Desc=''
Logs_B~WoodLand~MOD:	Title='Wood logs <color=yellow>Woodland</color>', Desc=''
LowGround_Big_24C~Catacombs~MOD:	Title='Big Room <color=yellow>Catacombs</color>', Desc=''
LowGround_Crossroad_12C~Catacombs~MOD:	Title='Crossroad <color=yellow>Catacombs</color>', Desc=''
LowGround_Small_24C~Catacombs~MOD:	Title='Small Room <color=yellow>Catacombs</color>', Desc=''
ManholeCover_B~Town~MOD:	Title='Manhole Cover <color=yellow>Town</color>', Desc=''
MarketBooth_A~LavaCaves~MOD:	Title='Market Booth <color=yellow>Lava Caves</color>', Desc=''
MarketBooth_B~LavaCaves~MOD:	Title='Market Booth <color=yellow>Lava Caves</color>', Desc=''
MarketBooth_C~LavaCaves~MOD:	Title='Market Booth <color=yellow>Lava Caves</color>', Desc=''
MarketBooth_D~LavaCaves~MOD:	Title='Market Booth <color=yellow>Lava Caves</color>', Desc=''
Merchant_Banner~Town~MOD:	Title='Merchant Banner <color=yellow>Town</color>', Desc=''
Merchant_Sign~Town~MOD:	Title='Merchant Sign <color=yellow>Town</color>', Desc=''
Mirror_A~Stronghold~MOD:	Title='Mirror <color=yellow>Stronghold</color>', Desc=''
Mirror_A~TownInterior~MOD:	Title='Mirror <color=yellow>Town Interiors</color>', Desc=''
Mirror_B_Covered~Stronghold~MOD:	Title='Mirror <color=yellow>Stronghold</color>', Desc=''
Mirror_B~Stronghold~MOD:	Title='Mirror <color=yellow>Stronghold</color>', Desc=''
Mirror_B~TownInterior~MOD:	Title='Mirror <color=yellow>Town Interiors</color>', Desc=''
Mirror_C~Stronghold~MOD:	Title='Mirror <color=yellow>Stronghold</color>', Desc=''
Mirror_C~TownInterior~MOD:	Title='Mirror <color=yellow>Town Interiors</color>', Desc=''
Monument_A~Necropolis~MOD:	Title='Monument <color=yellow>Necropolis</color>', Desc=''
Mushrooms_A~Catacombs~MOD:	Title='Mushrooms <color=yellow>Catacombs</color>', Desc=''
Mushrooms_A~LavaCaves~MOD:	Title='Mushrooms <color=yellow>Lava Caves</color>', Desc=''
Mushrooms_B~Catacombs~MOD:	Title='Mushrooms <color=yellow>Catacombs</color>', Desc=''
Mushrooms_B~LavaCaves~MOD:	Title='Mushrooms <color=yellow>Lava Caves</color>', Desc=''
NightStand_A~TownInterior~MOD:	Title='Nightstand <color=yellow>Town Interiors</color>', Desc=''
NightStand_B~TownInterior~MOD:	Title='Nightstand <color=yellow>Town Interiors</color>', Desc=''
NightStand_C~TownInterior~MOD:	Title='Nightstand <color=yellow>Town Interiors</color>', Desc=''
OldMine_Debris_A~LavaCaves~MOD:	Title='Debris <color=yellow>Lava Caves</color>', Desc=''
OldMine_Structure_A~LavaCaves~MOD:	Title='Structure <color=yellow>Lava Caves</color>', Desc=''
OldMine_Structure_B~LavaCaves~MOD:	Title='Structure <color=yellow>Lava Caves</color>', Desc=''
OldMine_Structure_C~LavaCaves~MOD:	Title='Structure <color=yellow>Lava Caves</color>', Desc=''
OldMine_Structure_D~LavaCaves~MOD:	Title='Structure <color=yellow>Lava Caves</color>', Desc=''
OldMine_Structure_E~LavaCaves~MOD:	Title='Structure <color=yellow>Lava Caves</color>', Desc=''
Paint_A_Covered~Stronghold~MOD:	Title='Painting <color=yellow>Stronghold</color>', Desc=''
Paint_A~Stronghold~MOD:	Title='Painting <color=yellow>Stronghold</color>', Desc=''
Paint_A~TownInterior~MOD:	Title='Painting <color=yellow>Town Interiors</color>', Desc=''
Paint_B_Covered~Stronghold~MOD:	Title='Painting <color=yellow>Stronghold</color>', Desc=''
Paint_B~Stronghold~MOD:	Title='Painting <color=yellow>Stronghold</color>', Desc=''
Paint_B~TownInterior~MOD:	Title='Painting <color=yellow>Town Interiors</color>', Desc=''
Paint_C_Covered~Stronghold~MOD:	Title='Painting <color=yellow>Stronghold</color>', Desc=''
Paint_C~Stronghold~MOD:	Title='Painting <color=yellow>Stronghold</color>', Desc=''
Paint_C~TownInterior~MOD:	Title='Painting <color=yellow>Town Interiors</color>', Desc=''
Path_Crossroad~WoodLand~MOD:	Title='X-shaped crossroads <color=yellow>Woodland</color>', Desc=''
Path_End~WoodLand~MOD:	Title='Dead end <color=yellow>Woodland</color>', Desc=''
Path_Sjunction_A~WoodLand~MOD:	Title='S-shaped crossroads <color=yellow>Woodland</color>', Desc=''
Path_Sjunction_B~WoodLand~MOD:	Title='S-shaped crossroads <color=yellow>Woodland</color>', Desc=''
Path_Straight_A~WoodLand~MOD:	Title='Straight path <color=yellow>Woodland</color>', Desc=''
Path_Straight_B~WoodLand~MOD:	Title='Straight path <color=yellow>Woodland</color>', Desc=''
Path_Straight_C~WoodLand~MOD:	Title='Straight path <color=yellow>Woodland</color>', Desc=''
Path_Straight_D~WoodLand~MOD:	Title='Straight path <color=yellow>Woodland</color>', Desc=''
Path_Turn~WoodLand~MOD:	Title='Curved path <color=yellow>Woodland</color>', Desc=''
Path_Yjunction~WoodLand~MOD:	Title='Y-shaped crossroads <color=yellow>Woodland</color>', Desc=''
Paved_Road_DeadEnd~Town~MOD:	Title='Paved Road Dead End <color=yellow>Town</color>', Desc=''
Paved_Road_RoundCenter_A~Town~MOD:	Title='Paved Road Square <color=yellow>Town</color>', Desc=''
Paved_Road_RoundCenter_B~Town~MOD:	Title='Paved Road Square <color=yellow>Town</color>', Desc=''
Paved_Road_RoundTurn~Town~MOD:	Title='Paved Road Turn <color=yellow>Town</color>', Desc=''
Paved_Road_SquareCenter_A~Town~MOD:	Title='Paved Road Square <color=yellow>Town</color>', Desc=''
Paved_Road_SquareCenter_B~Town~MOD:	Title='Paved Road Square <color=yellow>Town</color>', Desc=''
Paved_Road_SquareCenter_C~Town~MOD:	Title='Paved Road Square <color=yellow>Town</color>', Desc=''
Paved_Road_Straight_1C~Town~MOD:	Title='Paved Road Straight <color=yellow>Town</color>', Desc=''
Paved_Road_Straight_2C~Town~MOD:	Title='Paved Road Straight <color=yellow>Town</color>', Desc=''
Paved_Road_Straight_3C~Town~MOD:	Title='Paved Road Straight <color=yellow>Town</color>', Desc=''
Paved_Road_Straight_4C~Town~MOD:	Title='Paved Road Straight <color=yellow>Town</color>', Desc=''
Paved_Road_TShape~Town~MOD:	Title='Paved Road T-Shape <color=yellow>Town</color>', Desc=''
Paved_Road_XCrossRoads~Town~MOD:	Title='Paved Road Cross Section <color=yellow>Town</color>', Desc=''
Pennant_A~Town~MOD:	Title='Pennant <color=yellow>Town</color>', Desc=''
Pennant_A~TownInterior~MOD:	Title='Pennant <color=yellow>Town Interiors</color>', Desc=''
Pennant_B~Town~MOD:	Title='Pennant <color=yellow>Town</color>', Desc=''
Pennant_B~TownInterior~MOD:	Title='Pennant <color=yellow>Town Interiors</color>', Desc=''
Planks_A~Town~MOD:	Title='Wood planks <color=yellow>Town</color>', Desc=''
Planks_A~WoodLand~MOD:	Title='Wood planks <color=yellow>Woodland</color>', Desc=''
Planks_B~Town~MOD:	Title='Wood planks <color=yellow>Town</color>', Desc=''
Planks_B~WoodLand~MOD:	Title='Wood planks <color=yellow>Woodland</color>', Desc=''
Planks_C~Town~MOD:	Title='Wood planks <color=yellow>Town</color>', Desc=''
Planks_C~WoodLand~MOD:	Title='Wood planks <color=yellow>Woodland</color>', Desc=''
Plant_A~ElvenPalace~MOD:	Title='Plant <color=yellow>Elven Palace</color>', Desc=''
Plant_B~ElvenPalace~MOD:	Title='Plant <color=yellow>Elven Palace</color>', Desc=''
PoisonBulb~Sewers~MOD:	Title='Poison Bulb <color=yellow>Sewers</color>', Desc=''
PoisonBulb~WoodLand~MOD:	Title='Poison Bulb <color=yellow>Woodland</color>', Desc=''
Pond_Large_24C~WoodLand~MOD:	Title='Large Pond <color=yellow>Woodland</color>', Desc=''
Pond_Small_12C~WoodLand~MOD:	Title='Small Pond <color=yellow>Woodland</color>', Desc=''
PrisonFence_Link_LowGround~Catacombs~MOD:	Title='Prison Fence <color=yellow>Catacombs</color>', Desc=''
PrisonFence_Link_LowGround~Sewers~MOD:	Title='Prison Fence <color=yellow>Sewers</color>', Desc=''
PrisonFence_Link~Catacombs~MOD:	Title='Prison Fence <color=yellow>Catacombs</color>', Desc=''
PrisonFence_Link~Sewers~MOD:	Title='Prison Fence <color=yellow>Sewers</color>', Desc=''
PrisonFence_Link~Stronghold~MOD:	Title='Prison Fence <color=yellow>Stronghold</color>', Desc=''
PrisonFence_Straight_A~Catacombs~MOD:	Title='Prison Fence <color=yellow>Catacombs</color>', Desc=''
PrisonFence_Straight_A~Sewers~MOD:	Title='Prison Fence <color=yellow>Sewers</color>', Desc=''
PrisonFence_Straight_A~Stronghold~MOD:	Title='Prison Fence <color=yellow>Stronghold</color>', Desc=''
PrisonFence_Straight_LowGround_A~Catacombs~MOD:	Title='Prison Fence <color=yellow>Catacombs</color>', Desc=''
PrisonFence_Straight_LowGround_A~Sewers~MOD:	Title='Prison Fence <color=yellow>Sewers</color>', Desc=''
ReadingDesk_A~ElvenPalace~MOD:	Title='Reading Desk <color=yellow>Elven Palace</color>', Desc=''
ReadingDesk_A~Stronghold~MOD:	Title='Reading Desk <color=yellow>Stronghold</color>', Desc=''
ReadingDesk_B~ElvenPalace~MOD:	Title='Reading Desk <color=yellow>Elven Palace</color>', Desc=''
ReadingDesk_B~Stronghold~MOD:	Title='Reading Desk <color=yellow>Stronghold</color>', Desc=''
RitualStone_A~WoodLand~MOD:	Title='Ritual Stone <color=yellow>Woodland</color>', Desc=''
RitualStone_B~WoodLand~MOD:	Title='Ritual Stone <color=yellow>Woodland</color>', Desc=''
River_A_Large_24C~WoodLand~MOD:	Title='River <color=yellow>Woodland</color>', Desc=''
River_B_Large_24C~WoodLand~MOD:	Title='River <color=yellow>Woodland</color>', Desc=''
River_C_Large_24C~WoodLand~MOD:	Title='River <color=yellow>Woodland</color>', Desc=''
River_D_Large_24C~WoodLand~MOD:	Title='River <color=yellow>Woodland</color>', Desc=''
Rock_A~Catacombs~MOD:	Title='Rock <color=yellow>Catacombs</color>', Desc=''
Rock_A~LavaCaves~MOD:	Title='Rock <color=yellow>Lava Caves</color>', Desc=''
Rock_A~Town~MOD:	Title='Rock <color=yellow>Town</color>', Desc=''
Rock_A~WoodLand~MOD:	Title='Rock <color=yellow>Woodland</color>', Desc=''
Rock_B~Catacombs~MOD:	Title='Rock <color=yellow>Catacombs</color>', Desc=''
Rock_B~LavaCaves~MOD:	Title='Rock <color=yellow>Lava Caves</color>', Desc=''
Rock_B~Town~MOD:	Title='Rock <color=yellow>Town</color>', Desc=''
Rock_B~WoodLand~MOD:	Title='Rock <color=yellow>Woodland</color>', Desc=''
Rock_C~Catacombs~MOD:	Title='Rock <color=yellow>Catacombs</color>', Desc=''
Rock_C~LavaCaves~MOD:	Title='Rock <color=yellow>Lava Caves</color>', Desc=''
Rock_C~Town~MOD:	Title='Rock <color=yellow>Town</color>', Desc=''
Rock_C~WoodLand~MOD:	Title='Rock <color=yellow>Woodland</color>', Desc=''
Rock_D~Catacombs~MOD:	Title='Rock <color=yellow>Catacombs</color>', Desc=''
Rock_D~LavaCaves~MOD:	Title='Rock <color=yellow>Lava Caves</color>', Desc=''
Rock_E~LavaCaves~MOD:	Title='Rock <color=yellow>Lava Caves</color>', Desc=''
Rock_F~Catacombs~MOD:	Title='Rock <color=yellow>Catacombs</color>', Desc=''
Rock_F~LavaCaves~MOD:	Title='Rock <color=yellow>Lava Caves</color>', Desc=''
Rock_G~Catacombs~MOD:	Title='Rock <color=yellow>Catacombs</color>', Desc=''
Rock_G~LavaCaves~MOD:	Title='Rock <color=yellow>Lava Caves</color>', Desc=''
Room_A_12C~TownInterior~MOD:	Title='Small Room <color=yellow>Town Interiors</color>', Desc=''
Room_B_12C~TownInterior~MOD:	Title='Small Room <color=yellow>Town Interiors</color>', Desc=''
Room_Big_24C_A_Organic~LavaCaves~MOD:	Title='Big Room <color=yellow>Lava Caves</color>', Desc=''
Room_Big_24C_B_Organic~LavaCaves~MOD:	Title='Big Room <color=yellow>Lava Caves</color>', Desc=''
Room_Big_24C_C_Organic~LavaCaves~MOD:	Title='Big Room <color=yellow>Lava Caves</color>', Desc=''
Room_Big_24C~Catacombs~MOD:	Title='Big Room <color=yellow>Catacombs</color>', Desc=''
Room_Big_24C~ElvenPalace~MOD:	Title='Big Room <color=yellow>Elven Palace</color>', Desc=''
Room_Big_24C~Necropolis~MOD:	Title='Big Room <color=yellow>Necropolis</color>', Desc=''
Room_Big_24C~Sewers~MOD:	Title='Big Room <color=yellow>Sewers</color>', Desc=''
Room_Big_24C~Stronghold~MOD:	Title='Big Room <color=yellow>Stronghold</color>', Desc=''
Room_Big_24C~TownInterior~MOD:	Title='Big Room <color=yellow>Town Interiors</color>', Desc=''
Room_Big_48C_Organic~LavaCaves~MOD:	Title='Huge Room <color=yellow>Lava Caves</color>', Desc=''
Room_Big_HighGround_A_24C~TownInterior~MOD:	Title='Big Room with highground <color=yellow>Town Interiors</color>', Desc=''
Room_Big_HighGround_B_24C~TownInterior~MOD:	Title='Big Room with highground <color=yellow>Town Interiors</color>', Desc=''
Room_Half_48C_Organic~LavaCaves~MOD:	Title='Huge Room <color=yellow>Lava Caves</color>', Desc=''
Room_High_12C~TownInterior~MOD:	Title='Small Room with highground <color=yellow>Town Interiors</color>', Desc=''
Room_High_Line_12C~TownInterior~MOD:	Title='Small Room with highground <color=yellow>Town Interiors</color>', Desc=''
Room_Small_24C_A_Organic~LavaCaves~MOD:	Title='Small Room <color=yellow>Lava Caves</color>', Desc=''
Room_Small_24C_B_Organic~LavaCaves~MOD:	Title='Small Room <color=yellow>Lava Caves</color>', Desc=''
Room_Small_24C~Catacombs~MOD:	Title='Small Room <color=yellow>Catacombs</color>', Desc=''
Room_Small_24C~ElvenPalace~MOD:	Title='Small Room <color=yellow>Elven Palace</color>', Desc=''
Room_Small_24C~Necropolis~MOD:	Title='Small Room <color=yellow>Necropolis</color>', Desc=''
Room_Small_24C~Sewers~MOD:	Title='Small Room <color=yellow>Sewers</color>', Desc=''
Room_Small_24C~Stronghold~MOD:	Title='Small Room <color=yellow>Stronghold</color>', Desc=''
Room_Small_24C~TownInterior~MOD:	Title='Small Room <color=yellow>Town Interiors</color>', Desc=''
Room_Small_High_24C~TownInterior~MOD:	Title='Small Room with highground <color=yellow>Town Interiors</color>', Desc=''
Root_A~Sewers~MOD:	Title='Roots <color=yellow>Sewers</color>', Desc=''
Root_B~Sewers~MOD:	Title='Roots <color=yellow>Sewers</color>', Desc=''
Root_C~Sewers~MOD:	Title='Roots <color=yellow>Sewers</color>', Desc=''
Ruin_Large_24C~WoodLand~MOD:	Title='Large Clearing with ruins <color=yellow>Woodland</color>', Desc=''
Ruin_Small_12C~WoodLand~MOD:	Title='Small Clearing with ruins <color=yellow>Woodland</color>', Desc=''
RuinedArch_A~WoodLand~MOD:	Title='Arch <color=yellow>Woodland</color>', Desc=''
RuinedArch_B~WoodLand~MOD:	Title='Arch <color=yellow>Woodland</color>', Desc=''
RuinedArchEnd_A~WoodLand~MOD:	Title='Destroyed Arch <color=yellow>Woodland</color>', Desc=''
RuinedArchEnd_B~WoodLand~MOD:	Title='Destroyed Arch <color=yellow>Woodland</color>', Desc=''
RuinedKiosk_A~WoodLand~MOD:	Title='Ruined kiosk <color=yellow>Woodland</color>', Desc=''
RuinedKiosk_B~WoodLand~MOD:	Title='Ruined kiosk <color=yellow>Woodland</color>', Desc=''
RuinedWall_A~WoodLand~MOD:	Title='Ruined wall <color=yellow>Woodland</color>', Desc=''
RuinedWall_B~WoodLand~MOD:	Title='Ruined wall <color=yellow>Woodland</color>', Desc=''
RuinedWall_C~WoodLand~MOD:	Title='Ruined wall <color=yellow>Woodland</color>', Desc=''
RuinedWall_D~WoodLand~MOD:	Title='Ruined wall <color=yellow>Woodland</color>', Desc=''
RuinedWall_E~WoodLand~MOD:	Title='Ruined wall <color=yellow>Woodland</color>', Desc=''
RuinedWall_F~WoodLand~MOD:	Title='Ruined wall <color=yellow>Woodland</color>', Desc=''
Scaffolding_A~Catacombs~MOD:	Title='Scaffoldings <color=yellow>Catacombs</color>', Desc=''
Scaffolding_A~Sewers~MOD:	Title='Scaffoldings <color=yellow>Sewers</color>', Desc=''
Scaffolding_B~Catacombs~MOD:	Title='Scaffoldings <color=yellow>Catacombs</color>', Desc=''
Scaffolding_B~Sewers~MOD:	Title='Scaffoldings <color=yellow>Sewers</color>', Desc=''
Scaffolding_C~Catacombs~MOD:	Title='Scaffoldings <color=yellow>Catacombs</color>', Desc=''
Scaffolding_C~Sewers~MOD:	Title='Scaffoldings <color=yellow>Sewers</color>', Desc=''
Shelves_A~Catacombs~MOD:	Title='Shelves <color=yellow>Catacombs</color>', Desc=''
Shelves_A~ElvenPalace~MOD:	Title='Shelves <color=yellow>Elven Palace</color>', Desc=''
Shelves_A~Sewers~MOD:	Title='Shelves <color=yellow>Sewers</color>', Desc=''
Shelves_A~Stronghold~MOD:	Title='Shelves <color=yellow>Stronghold</color>', Desc=''
Shelves_A~WoodLand~MOD:	Title='Shelves <color=yellow>Woodland</color>', Desc=''
Shelves_B~Catacombs~MOD:	Title='Shelves <color=yellow>Catacombs</color>', Desc=''
Shelves_B~ElvenPalace~MOD:	Title='Shelves <color=yellow>Elven Palace</color>', Desc=''
Shelves_B~Sewers~MOD:	Title='Shelves <color=yellow>Sewers</color>', Desc=''
Shelves_B~Stronghold~MOD:	Title='Shelves <color=yellow>Stronghold</color>', Desc=''
Shelves_B~WoodLand~MOD:	Title='Shelves <color=yellow>Woodland</color>', Desc=''
Shelves_C~Catacombs~MOD:	Title='Shelves <color=yellow>Catacombs</color>', Desc=''
Shelves_C~ElvenPalace~MOD:	Title='Shelves <color=yellow>Elven Palace</color>', Desc=''
Shelves_C~Sewers~MOD:	Title='Shelves <color=yellow>Sewers</color>', Desc=''
Shelves_C~Stronghold~MOD:	Title='Shelves <color=yellow>Stronghold</color>', Desc=''
Shelves_C~WoodLand~MOD:	Title='Shelves <color=yellow>Woodland</color>', Desc=''
Shelves_D~Catacombs~MOD:	Title='Shelves <color=yellow>Catacombs</color>', Desc=''
Shelves_D~ElvenPalace~MOD:	Title='Shelves <color=yellow>Elven Palace</color>', Desc=''
Shelves_D~Sewers~MOD:	Title='Shelves <color=yellow>Sewers</color>', Desc=''
Shelves_D~Stronghold~MOD:	Title='Shelves <color=yellow>Stronghold</color>', Desc=''
Shelves_D~WoodLand~MOD:	Title='Shelves <color=yellow>Woodland</color>', Desc=''
Shelves_E~Catacombs~MOD:	Title='Shelves <color=yellow>Catacombs</color>', Desc=''
Shelves_TownInt_A~TownInterior~MOD:	Title='Shelves <color=yellow>Town Interiors</color>', Desc=''
Shelves_TownInt_B~TownInterior~MOD:	Title='Shelves <color=yellow>Town Interiors</color>', Desc=''
Shelves_TownInt_C~TownInterior~MOD:	Title='Shelves <color=yellow>Town Interiors</color>', Desc=''
Shelves_TownInt_D~TownInterior~MOD:	Title='Shelves <color=yellow>Town Interiors</color>', Desc=''
Shop_Big_Structure_A~Town~MOD:	Title='Shop Structure <color=yellow>Town</color>', Desc=''
Shop_Big_Structure_B~Town~MOD:	Title='Shop Structure <color=yellow>Town</color>', Desc=''
Shop_Big_Structure_C~Town~MOD:	Title='Shop Structure <color=yellow>Town</color>', Desc=''
Shop_Big_Structure_D~Town~MOD:	Title='Shop Structure <color=yellow>Town</color>', Desc=''
Shop_Book_Stand_A~Town~MOD:	Title='Book Shop Stand <color=yellow>Town</color>', Desc=''
Shop_Book_Stand_B~Town~MOD:	Title='Book Shop Stand <color=yellow>Town</color>', Desc=''
Shop_Book_Stand_C~Town~MOD:	Title='Book Shop Stand <color=yellow>Town</color>', Desc=''
Shop_Food_Stand_A~Town~MOD:	Title='Food Shop Stand <color=yellow>Town</color>', Desc=''
Shop_Food_Stand_B~Town~MOD:	Title='Food Shop Stand <color=yellow>Town</color>', Desc=''
Shop_Food_Stand_C~Town~MOD:	Title='Food Shop Stand <color=yellow>Town</color>', Desc=''
Shop_Food_Stand_D~Town~MOD:	Title='Food Shop Stand <color=yellow>Town</color>', Desc=''
Shop_Food_Stand_E~Town~MOD:	Title='Food Shop Stand <color=yellow>Town</color>', Desc=''
Shop_General Store~Town~MOD:	Title='General Store Stand <color=yellow>Town</color>', Desc=''
Shop_Generic_NoShed_A~Town~MOD:	Title='Generic Shop Stand <color=yellow>Town</color>', Desc=''
Shop_Generic_NoShed_B~Town~MOD:	Title='Generic Shop Stand <color=yellow>Town</color>', Desc=''
Shop_Generic_NoShed_C~Town~MOD:	Title='Generic Shop Stand <color=yellow>Town</color>', Desc=''
Shop_Generic_NoShed_D~Town~MOD:	Title='Generic Shop Stand <color=yellow>Town</color>', Desc=''
Shop_Generic_Shed_A~Town~MOD:	Title='Generic Shop Stand <color=yellow>Town</color>', Desc=''
Shop_Generic_Shed_B~Town~MOD:	Title='Generic Shop Stand <color=yellow>Town</color>', Desc=''
Shop_Generic_Shed_C~Town~MOD:	Title='Generic Shop Stand <color=yellow>Town</color>', Desc=''
Shop_Generic_Shed_D~Town~MOD:	Title='Generic Shop Stand <color=yellow>Town</color>', Desc=''
Shop_Magic~Town~MOD:	Title='Magic Shop Stand <color=yellow>Town</color>', Desc=''
Shop_Stage_A~Town~MOD:	Title='Stairs <color=yellow>Town</color>', Desc=''
Shop_Stage_B~Town~MOD:	Title='Stairs <color=yellow>Town</color>', Desc=''
Shop_WoodenShed_A~Town~MOD:	Title='Wooden Shack <color=yellow>Town</color>', Desc=''
Shop_WoodenShed_B~Town~MOD:	Title='Wooden Shack <color=yellow>Town</color>', Desc=''
ShopBook_Counter_A~TownInterior~MOD:	Title='Book Shop Counter <color=yellow>Town Interiors</color>', Desc=''
ShopBook_Counter_B~TownInterior~MOD:	Title='Book Shop Counter <color=yellow>Town Interiors</color>', Desc=''
ShopBook_Counter_C~TownInterior~MOD:	Title='Book Shop Counter <color=yellow>Town Interiors</color>', Desc=''
ShopFood_Counter_A~TownInterior~MOD:	Title='Food Shop Counter <color=yellow>Town Interiors</color>', Desc=''
ShopFood_Counter_B~TownInterior~MOD:	Title='Food Shop Counter <color=yellow>Town Interiors</color>', Desc=''
ShopFood_Counter_C~TownInterior~MOD:	Title='Food Shop Counter <color=yellow>Town Interiors</color>', Desc=''
ShopGeneral_Counter_A~TownInterior~MOD:	Title='General Shop Counter <color=yellow>Town Interiors</color>', Desc=''
ShopGeneral_Counter_B~TownInterior~MOD:	Title='General Shop Counter <color=yellow>Town Interiors</color>', Desc=''
ShopGeneral_Counter_C~TownInterior~MOD:	Title='General Shop Counter <color=yellow>Town Interiors</color>', Desc=''
Skins_A~LavaCaves~MOD:	Title='Skins <color=yellow>Lava Caves</color>', Desc=''
Skins_B~LavaCaves~MOD:	Title='Skins <color=yellow>Lava Caves</color>', Desc=''
Skins_C~LavaCaves~MOD:	Title='Skins <color=yellow>Lava Caves</color>', Desc=''
SkullPile_A~Catacombs~MOD:	Title='Skull Pile <color=yellow>Catacombs</color>', Desc=''
SkullPile_B~Catacombs~MOD:	Title='Skull Pile <color=yellow>Catacombs</color>', Desc=''
SkullPile_C~Catacombs~MOD:	Title='Skull Pile <color=yellow>Catacombs</color>', Desc=''
Slope_A~Sewers~MOD:	Title='Slope <color=yellow>Sewers</color>', Desc=''
SmallWalls_A~Town~MOD:	Title='Town Inner Walls <color=yellow>Town</color>', Desc=''
SmallWalls_B~Town~MOD:	Title='Town Inner Walls <color=yellow>Town</color>', Desc=''
SmallWalls_Butress_A~Town~MOD:	Title='Town Inner Butress <color=yellow>Town</color>', Desc=''
SmallWalls_Butress_B~Town~MOD:	Title='Town Inner Butress <color=yellow>Town</color>', Desc=''
SmallWalls_C~Town~MOD:	Title='Town Inner Walls <color=yellow>Town</color>', Desc=''
SmallWalls_D~Town~MOD:	Title='Town Inner Walls <color=yellow>Town</color>', Desc=''
SmallWalls_E~Town~MOD:	Title='Town Inner Walls <color=yellow>Town</color>', Desc=''
SmallWalls_F~Town~MOD:	Title='Town Inner Walls <color=yellow>Town</color>', Desc=''
SmallWalls_G~Town~MOD:	Title='Town Inner Walls <color=yellow>Town</color>', Desc=''
SmallWalls_H~Town~MOD:	Title='Town Inner Walls <color=yellow>Town</color>', Desc=''
SpiderEggs_A~Catacombs~MOD:	Title='Spider Eggs <color=yellow>Catacombs</color>', Desc=''
SpiderEggs_A~LavaCaves~MOD:	Title='Spider Eggs <color=yellow>Lava Caves</color>', Desc=''
SpiderEggs_A~Necropolis~MOD:	Title='Spider Eggs <color=yellow>Necropolis</color>', Desc=''
SpiderEggs_A~Sewers~MOD:	Title='Spider Eggs <color=yellow>Sewers</color>', Desc=''
SpiderEggs_A~WoodLand~MOD:	Title='Spider Eggs <color=yellow>Woodland</color>', Desc=''
SpiderEggs_B~Catacombs~MOD:	Title='Spider Eggs <color=yellow>Catacombs</color>', Desc=''
SpiderEggs_B~LavaCaves~MOD:	Title='Spider Eggs <color=yellow>Lava Caves</color>', Desc=''
SpiderEggs_B~Necropolis~MOD:	Title='Spider Eggs <color=yellow>Necropolis</color>', Desc=''
SpiderEggs_B~Sewers~MOD:	Title='Spider Eggs <color=yellow>Sewers</color>', Desc=''
SpiderEggs_B~WoodLand~MOD:	Title='Spider Eggs <color=yellow>Woodland</color>', Desc=''
SpiderEggs_C~Catacombs~MOD:	Title='Spider Eggs <color=yellow>Catacombs</color>', Desc=''
SpiderEggs_C~LavaCaves~MOD:	Title='Spider Eggs <color=yellow>Lava Caves</color>', Desc=''
SpiderEggs_C~Necropolis~MOD:	Title='Spider Eggs <color=yellow>Necropolis</color>', Desc=''
SpiderEggs_C~Sewers~MOD:	Title='Spider Eggs <color=yellow>Sewers</color>', Desc=''
SpiderEggs_C~WoodLand~MOD:	Title='Spider Eggs <color=yellow>Woodland</color>', Desc=''
SpiderEggs_D~Catacombs~MOD:	Title='Spider Eggs <color=yellow>Catacombs</color>', Desc=''
SpiderEggs_D~LavaCaves~MOD:	Title='Spider Eggs <color=yellow>Lava Caves</color>', Desc=''
SpiderEggs_D~Necropolis~MOD:	Title='Spider Eggs <color=yellow>Necropolis</color>', Desc=''
SpiderEggs_D~Sewers~MOD:	Title='Spider Eggs <color=yellow>Sewers</color>', Desc=''
SpiderEggs_D~WoodLand~MOD:	Title='Spider Eggs <color=yellow>Woodland</color>', Desc=''
SpiderWebs_A~Catacombs~MOD:	Title='Spider Webs <color=yellow>Catacombs</color>', Desc=''
SpiderWebs_A~Necropolis~MOD:	Title='Spider Webs <color=yellow>Necropolis</color>', Desc=''
SpiderWebs_A~Sewers~MOD:	Title='Spider Webs <color=yellow>Sewers</color>', Desc=''
SpiderWebs_B~Catacombs~MOD:	Title='Spider Webs <color=yellow>Catacombs</color>', Desc=''
SpiderWebs_B~Necropolis~MOD:	Title='Spider Webs <color=yellow>Necropolis</color>', Desc=''
SpiderWebs_B~Sewers~MOD:	Title='Spider Webs <color=yellow>Sewers</color>', Desc=''
SpiderWebs_C~WoodLand~MOD:	Title='Spider Webs <color=yellow>Woodland</color>', Desc=''
SpiderWebs_D~WoodLand~MOD:	Title='Spider Webs <color=yellow>Woodland</color>', Desc=''
SpinningWheel~ElvenPalace~MOD:	Title='Spinning Wheel <color=yellow>Elven Palace</color>', Desc=''
Stable_A~Town~MOD:	Title='Stable <color=yellow>Town</color>', Desc=''
Stable_B~Town~MOD:	Title='Stable <color=yellow>Town</color>', Desc=''
Stable_C~Town~MOD:	Title='Stable <color=yellow>Town</color>', Desc=''
Stairs_A~Catacombs~MOD:	Title='Stairs <color=yellow>Catacombs</color>', Desc=''
Stairs_A~Sewers~MOD:	Title='Stairs <color=yellow>Sewers</color>', Desc=''
Stairs_B~Catacombs~MOD:	Title='Stairs <color=yellow>Catacombs</color>', Desc=''
Stairs_B~Sewers~MOD:	Title='Stairs <color=yellow>Sewers</color>', Desc=''
Stairs_Destroyed_A~Sewers~MOD:	Title='Destroyed Stairs <color=yellow>Sewers</color>', Desc=''
Stairs_Destroyed_B~Sewers~MOD:	Title='Destroyed Stairs <color=yellow>Sewers</color>', Desc=''
StairsTavern~TownInterior~MOD:	Title='Stairs <color=yellow>Town Interiors</color>', Desc=''
Stalagmite_A~Catacombs~MOD:	Title='Stalagmite <color=yellow>Catacombs</color>', Desc=''
Stalagmite_A~LavaCaves~MOD:	Title='Stalagmite <color=yellow>Lava Caves</color>', Desc=''
Stalagmite_B~Catacombs~MOD:	Title='Stalagmite <color=yellow>Catacombs</color>', Desc=''
Stalagmite_B~LavaCaves~MOD:	Title='Stalagmite <color=yellow>Lava Caves</color>', Desc=''
Stalagmite_B~Sewers~MOD:	Title='Stalagmite <color=yellow>Sewers</color>', Desc=''
Stalagmite_C~Catacombs~MOD:	Title='Stalagmite <color=yellow>Catacombs</color>', Desc=''
Stalagmite_C~LavaCaves~MOD:	Title='Stalagmite <color=yellow>Lava Caves</color>', Desc=''
Stalagmite_D~Sewers~MOD:	Title='Stalagmite <color=yellow>Sewers</color>', Desc=''
Statue_A~Catacombs~MOD:	Title='Statue <color=yellow>Catacombs</color>', Desc=''
Statue_A~ElvenPalace~MOD:	Title='Statue <color=yellow>Elven Palace</color>', Desc=''
Statue_A~Necropolis~MOD:	Title='Statue <color=yellow>Necropolis</color>', Desc=''
Statue_A~Stronghold~MOD:	Title='Statue <color=yellow>Stronghold</color>', Desc=''
Statue_B~Catacombs~MOD:	Title='Statue <color=yellow>Catacombs</color>', Desc=''
Statue_B~ElvenPalace~MOD:	Title='Statue <color=yellow>Elven Palace</color>', Desc=''
Statue_B~Necropolis~MOD:	Title='Statue <color=yellow>Necropolis</color>', Desc=''
Statue_B~Stronghold~MOD:	Title='Statue <color=yellow>Stronghold</color>', Desc=''
Statue_C~Catacombs~MOD:	Title='Statue <color=yellow>Catacombs</color>', Desc=''
Statue_C~ElvenPalace~MOD:	Title='Statue <color=yellow>Elven Palace</color>', Desc=''
Statue_C~Necropolis~MOD:	Title='Statue <color=yellow>Necropolis</color>', Desc=''
Statue_C~Stronghold~MOD:	Title='Statue <color=yellow>Stronghold</color>', Desc=''
Statue_D~Catacombs~MOD:	Title='Statue <color=yellow>Catacombs</color>', Desc=''
Statue_D~ElvenPalace~MOD:	Title='Statue <color=yellow>Elven Palace</color>', Desc=''
Statue_D~Necropolis~MOD:	Title='Statue <color=yellow>Necropolis</color>', Desc=''
Statue_D~Stronghold~MOD:	Title='Statue <color=yellow>Stronghold</color>', Desc=''
Statue_E_Covered~Stronghold~MOD:	Title='Statue <color=yellow>Stronghold</color>', Desc=''
Statue_Little_Emperor~Town~MOD:	Title='Statue of a young Emperor <color=yellow>Town</color>', Desc=''
Statue_Maisy_Jade~Town~MOD:	Title='Statue of Maisy (jade) <color=yellow>Town</color>', Desc=''
Statue_Maisy_Marble~Town~MOD:	Title='Statue of Maisy (marble) <color=yellow>Town</color>', Desc=''
Statue_Maisy_Stone~Town~MOD:	Title='Statue of Maisy (stone) <color=yellow>Town</color>', Desc=''
Statue_Misaye~Town~MOD:	Title='Statue of Misaye <color=yellow>Town</color>', Desc=''
Still_A~Stronghold~MOD:	Title='Still <color=yellow>Stronghold</color>', Desc=''
Still_Covered_A~Stronghold~MOD:	Title='Still <color=yellow>Stronghold</color>', Desc=''
Stone_A~Catacombs~MOD:	Title='Rock <color=yellow>Catacombs</color>', Desc=''
Stone_A~LavaCaves~MOD:	Title='Rock <color=yellow>Lava Caves</color>', Desc=''
Stone_A~Sewers~MOD:	Title='Rock <color=yellow>Sewers</color>', Desc=''
Stone_B~Catacombs~MOD:	Title='Rock <color=yellow>Catacombs</color>', Desc=''
Stone_B~LavaCaves~MOD:	Title='Rock <color=yellow>Lava Caves</color>', Desc=''
Stone_B~Sewers~MOD:	Title='Rock <color=yellow>Sewers</color>', Desc=''
Stone_C~Catacombs~MOD:	Title='Rock <color=yellow>Catacombs</color>', Desc=''
Stone_C~LavaCaves~MOD:	Title='Rock <color=yellow>Lava Caves</color>', Desc=''
Stone_C~Sewers~MOD:	Title='Rock <color=yellow>Sewers</color>', Desc=''
Stone_D~Catacombs~MOD:	Title='Rock <color=yellow>Catacombs</color>', Desc=''
Stone_D~LavaCaves~MOD:	Title='Rock <color=yellow>Lava Caves</color>', Desc=''
Stone_D~Sewers~MOD:	Title='Rock <color=yellow>Sewers</color>', Desc=''
Stone_E~Catacombs~MOD:	Title='Rock <color=yellow>Catacombs</color>', Desc=''
Stone_E~LavaCaves~MOD:	Title='Rock <color=yellow>Lava Caves</color>', Desc=''
Stone_E~Sewers~MOD:	Title='Rock <color=yellow>Sewers</color>', Desc=''
Stone_F~Catacombs~MOD:	Title='Rock <color=yellow>Catacombs</color>', Desc=''
Stone_F~LavaCaves~MOD:	Title='Rock <color=yellow>Lava Caves</color>', Desc=''
Stone_F~Sewers~MOD:	Title='Rock <color=yellow>Sewers</color>', Desc=''
Stool~Catacombs~MOD:	Title='Stool <color=yellow>Catacombs</color>', Desc=''
Stool~ElvenPalace~MOD:	Title='Stool <color=yellow>Elven Palace</color>', Desc=''
Stool~Stronghold~MOD:	Title='Stool <color=yellow>Stronghold</color>', Desc=''
Stool~Town~MOD:	Title='Stool <color=yellow>Town</color>', Desc=''
Stool~TownInterior~MOD:	Title='Stool <color=yellow>Town Interiors</color>', Desc=''
Stool~WoodLand~MOD:	Title='Stool <color=yellow>Woodland</color>', Desc=''
Stove~Sewers~MOD:	Title='Stove <color=yellow>Sewers</color>', Desc=''
Stove~Stronghold~MOD:	Title='Stove <color=yellow>Stronghold</color>', Desc=''
Stove~TownInterior~MOD:	Title='Stove <color=yellow>Town Interiors</color>', Desc=''
Stove~WoodLand~MOD:	Title='Stove <color=yellow>Woodland</color>', Desc=''
Straw_A~Catacombs~MOD:	Title='Straw <color=yellow>Catacombs</color>', Desc=''
Straw_A~LavaCaves~MOD:	Title='Straw <color=yellow>Lava Caves</color>', Desc=''
Straw_A~Stronghold~MOD:	Title='Straw <color=yellow>Stronghold</color>', Desc=''
Straw_A~Town~MOD:	Title='Straw <color=yellow>Town</color>', Desc=''
Straw_B~Catacombs~MOD:	Title='Straw <color=yellow>Catacombs</color>', Desc=''
Straw_B~LavaCaves~MOD:	Title='Straw <color=yellow>Lava Caves</color>', Desc=''
Straw_B~Stronghold~MOD:	Title='Straw <color=yellow>Stronghold</color>', Desc=''
Straw_B~Town~MOD:	Title='Straw <color=yellow>Town</color>', Desc=''
Street_Debris_A~Town~MOD:	Title='Debris <color=yellow>Town</color>', Desc=''
Street_Debris_B~Town~MOD:	Title='Debris <color=yellow>Town</color>', Desc=''
Street_Debris_C~Town~MOD:	Title='Debris <color=yellow>Town</color>', Desc=''
Street_Debris_D~Town~MOD:	Title='Debris <color=yellow>Town</color>', Desc=''
StreetLampost~Town~MOD:	Title='Street Lamp <color=yellow>Town</color>', Desc=''
Structure_A~LavaCaves~MOD:	Title='Structure <color=yellow>Lava Caves</color>', Desc=''
Structure_B~LavaCaves~MOD:	Title='Structure <color=yellow>Lava Caves</color>', Desc=''
Structure_C~LavaCaves~MOD:	Title='Structure <color=yellow>Lava Caves</color>', Desc=''
Stump_A~Town~MOD:	Title='A dead tree stump <color=yellow>Town</color>', Desc=''
Stump_A~WoodLand~MOD:	Title='A dead tree stump <color=yellow>Woodland</color>', Desc=''
Stump_B~Town~MOD:	Title='A dead tree stump <color=yellow>Town</color>', Desc=''
Stump_B~WoodLand~MOD:	Title='A dead tree stump <color=yellow>Woodland</color>', Desc=''
Stump_C~Town~MOD:	Title='A dead tree stump <color=yellow>Town</color>', Desc=''
Stump_C~WoodLand~MOD:	Title='A dead tree stump <color=yellow>Woodland</color>', Desc=''
Table_A_Covered~Catacombs~MOD:	Title='Table <color=yellow>Catacombs</color>', Desc=''
Table_A_Covered~Sewers~MOD:	Title='Table <color=yellow>Sewers</color>', Desc=''
Table_A_Covered~Stronghold~MOD:	Title='Table <color=yellow>Stronghold</color>', Desc=''
Table_A~Catacombs~MOD:	Title='Table <color=yellow>Catacombs</color>', Desc=''
Table_A~ElvenPalace~MOD:	Title='Table <color=yellow>Elven Palace</color>', Desc=''
Table_A~Sewers~MOD:	Title='Table <color=yellow>Sewers</color>', Desc=''
Table_A~Stronghold~MOD:	Title='Table <color=yellow>Stronghold</color>', Desc=''
Table_A~TownInterior~MOD:	Title='Table <color=yellow>Town Interiors</color>', Desc=''
Table_A~WoodLand~MOD:	Title='Table <color=yellow>Woodland</color>', Desc=''
Table_B~ElvenPalace~MOD:	Title='Table <color=yellow>Elven Palace</color>', Desc=''
Table_B~Stronghold~MOD:	Title='Table <color=yellow>Stronghold</color>', Desc=''
Table_B~TownInterior~MOD:	Title='Table <color=yellow>Town Interiors</color>', Desc=''
Table_C~Stronghold~MOD:	Title='Table <color=yellow>Stronghold</color>', Desc=''
Table_C~TownInterior~MOD:	Title='Table <color=yellow>Town Interiors</color>', Desc=''
Table_D~ElvenPalace~MOD:	Title='Table <color=yellow>Elven Palace</color>', Desc=''
TableTavern_A~TownInterior~MOD:	Title='Table <color=yellow>Town Interiors</color>', Desc=''
TavernRail_Kit_A~TownInterior~MOD:	Title='Guardrails <color=yellow>Town Interiors</color>', Desc=''
TavernRailEnd_Kit~TownInterior~MOD:	Title='Guardrails <color=yellow>Town Interiors</color>', Desc=''
Telescope_A~ElvenPalace~MOD:	Title='Telescope <color=yellow>Elven Palace</color>', Desc=''
Telescope_B~ElvenPalace~MOD:	Title='Telescope <color=yellow>Elven Palace</color>', Desc=''
Tent_A~WoodLand~MOD:	Title='Tent <color=yellow>Woodland</color>', Desc=''
Tent_B~WoodLand~MOD:	Title='Tent <color=yellow>Woodland</color>', Desc=''
Tent_C~WoodLand~MOD:	Title='Tent <color=yellow>Woodland</color>', Desc=''
Tent_D~WoodLand~MOD:	Title='Tent <color=yellow>Woodland</color>', Desc=''
Tent_E~WoodLand~MOD:	Title='Tent <color=yellow>Woodland</color>', Desc=''
Tent_F~WoodLand~MOD:	Title='Tent <color=yellow>Woodland</color>', Desc=''
Thicket_A~Town~MOD:	Title='Thicket <color=yellow>Town</color>', Desc=''
Thicket_A~WoodLand~MOD:	Title='Thicket <color=yellow>Woodland</color>', Desc=''
Thicket_B~Town~MOD:	Title='Thicket <color=yellow>Town</color>', Desc=''
Thicket_B~WoodLand~MOD:	Title='Thicket <color=yellow>Woodland</color>', Desc=''
Thicket_C~Town~MOD:	Title='Thicket <color=yellow>Town</color>', Desc=''
Thicket_C~WoodLand~MOD:	Title='Thicket <color=yellow>Woodland</color>', Desc=''
Tombstone_A~Town~MOD:	Title='Tombstone <color=yellow>Town</color>', Desc=''
Tombstone_A~WoodLand~MOD:	Title='Tombstone <color=yellow>Woodland</color>', Desc=''
Tombstone_B~Town~MOD:	Title='Tombstone <color=yellow>Town</color>', Desc=''
Tombstone_B~WoodLand~MOD:	Title='Tombstone <color=yellow>Woodland</color>', Desc=''
Tombstone_C~Town~MOD:	Title='Tombstone <color=yellow>Town</color>', Desc=''
Tombstone_C~WoodLand~MOD:	Title='Tombstone <color=yellow>Woodland</color>', Desc=''
Tombstone_D~Town~MOD:	Title='Tombstone <color=yellow>Town</color>', Desc=''
Tombstone_D~WoodLand~MOD:	Title='Tombstone <color=yellow>Woodland</color>', Desc=''
TombstonePack_A~Town~MOD:	Title='Pack of tombstones <color=yellow>Town</color>', Desc=''
TombstonePack_A~WoodLand~MOD:	Title='Pack of tombstones <color=yellow>Woodland</color>', Desc=''
TombstonePack_B~Town~MOD:	Title='Pack of tombstones <color=yellow>Town</color>', Desc=''
TombstonePack_B~WoodLand~MOD:	Title='Pack of tombstones <color=yellow>Woodland</color>', Desc=''
TombstonePack_C~Town~MOD:	Title='Pack of tombstones <color=yellow>Town</color>', Desc=''
TombstonePack_C~WoodLand~MOD:	Title='Pack of tombstones <color=yellow>Woodland</color>', Desc=''
TorchPike~Catacombs~MOD:	Title='Torch Pike <color=yellow>Catacombs</color>', Desc=''
TorchPike~LavaCaves~MOD:	Title='Torch Pike <color=yellow>Lava Caves</color>', Desc=''
TorchPike~Town~MOD:	Title='Torch Pike <color=yellow>Town</color>', Desc=''
TorchPike~WoodLand~MOD:	Title='Torch Pike <color=yellow>Woodland</color>', Desc=''
Totem_A~LavaCaves~MOD:	Title='Totem <color=yellow>Lava Caves</color>', Desc=''
Totem_B~LavaCaves~MOD:	Title='Totem <color=yellow>Lava Caves</color>', Desc=''
Totem_C~LavaCaves~MOD:	Title='Totem <color=yellow>Lava Caves</color>', Desc=''
Town_Corner_12C~Town~MOD:	Title='Small district with walls <color=yellow>Town</color>', Desc=''
Town_Entrance_24C~Town~MOD:	Title='Town entrance <color=yellow>Town</color>', Desc=''
Town_Large_24C~Town~MOD:	Title='Large district <color=yellow>Town</color>', Desc=''
Town_Medium_12C~Town~MOD:	Title='Small district <color=yellow>Town</color>', Desc=''
Town_Medium_Exterior_A_12C~Town~MOD:	Title='Small district outside <color=yellow>Town</color>', Desc=''
Town_Medium_Exterior_B_12C~Town~MOD:	Title='Small district outside <color=yellow>Town</color>', Desc=''
Town_Walls_A_12C~Town~MOD:	Title='Small district with walls <color=yellow>Town</color>', Desc=''
Town_Walls_B_12C~Town~MOD:	Title='Small district with walls <color=yellow>Town</color>', Desc=''
Town_Walls_C_12C~Town~MOD:	Title='Small district with walls <color=yellow>Town</color>', Desc=''
Town_Walls_D_12C~Town~MOD:	Title='Small district with walls <color=yellow>Town</color>', Desc=''
TreasurePedestal~Stronghold~MOD:	Title='Treasure Pedestal <color=yellow>Stronghold</color>', Desc=''
Tree_A~Town~MOD:	Title='Single Tree <color=yellow>Town</color>', Desc=''
Tree_B~Town~MOD:	Title='Single Tree <color=yellow>Town</color>', Desc=''
Tree_C~Town~MOD:	Title='Single Tree <color=yellow>Town</color>', Desc=''
Trophy_Wolf~Stronghold~MOD:	Title='Hunting Trophy <color=yellow>Stronghold</color>', Desc=''
Trophy_Wolf~TownInterior~MOD:	Title='Hunting Trophy <color=yellow>Town Interiors</color>', Desc=''
Trunk_A~WoodLand~MOD:	Title='Trunk <color=yellow>Woodland</color>', Desc=''
Turn_12C_Organic~LavaCaves~MOD:	Title='Turn <color=yellow>Lava Caves</color>', Desc=''
Turn_12C~Catacombs~MOD:	Title='Turn <color=yellow>Catacombs</color>', Desc=''
Turn_12C~ElvenPalace~MOD:	Title='Turn <color=yellow>Elven Palace</color>', Desc=''
Turn_12C~Necropolis~MOD:	Title='Turn <color=yellow>Necropolis</color>', Desc=''
Turn_12C~Sewers~MOD:	Title='Turn <color=yellow>Sewers</color>', Desc=''
Turn_12C~Stronghold~MOD:	Title='Turn <color=yellow>Stronghold</color>', Desc=''
Wall_Destroyed_A~Sewers~MOD:	Title='Destroyed Wall <color=yellow>Sewers</color>', Desc=''
Wall_Link~Catacombs~MOD:	Title='Wall Link <color=yellow>Catacombs</color>', Desc=''
Wall_Link~ElvenPalace~MOD:	Title='Wall Link <color=yellow>Elven Palace</color>', Desc=''
Wall_Link~Necropolis~MOD:	Title='Wall Link <color=yellow>Necropolis</color>', Desc=''
Wall_Link~Sewers~MOD:	Title='Wall Link <color=yellow>Sewers</color>', Desc=''
Wall_Link~Stronghold~MOD:	Title='Wall Link <color=yellow>Stronghold</color>', Desc=''
Wall_Simple_A~ElvenPalace~MOD:	Title='Free Wall <color=yellow>Elven Palace</color>', Desc=''
Wall_Simple_A~LavaCaves~MOD:	Title='Free Wall <color=yellow>Lava Caves</color>', Desc=''
Wall_Simple_A~Necropolis~MOD:	Title='Free Wall <color=yellow>Necropolis</color>', Desc=''
Wall_Simple_A~Sewers~MOD:	Title='Free Wall <color=yellow>Sewers</color>', Desc=''
Wall_Simple_A~Stronghold~MOD:	Title='Free Wall <color=yellow>Stronghold</color>', Desc=''
Wall_Simple_B~Catacombs~MOD:	Title='Free Wall <color=yellow>Catacombs</color>', Desc=''
Wall_Simple_B~ElvenPalace~MOD:	Title='Free Wall <color=yellow>Elven Palace</color>', Desc=''
Wall_Simple_B~LavaCaves~MOD:	Title='Free Wall <color=yellow>Lava Caves</color>', Desc=''
Wall_Simple_B~Necropolis~MOD:	Title='Free Wall <color=yellow>Necropolis</color>', Desc=''
Wall_Simple_B~Sewers~MOD:	Title='Free Wall <color=yellow>Sewers</color>', Desc=''
Wall_Simple_B~Stronghold~MOD:	Title='Free Wall <color=yellow>Stronghold</color>', Desc=''
Wall_Simple_C~Catacombs~MOD:	Title='Free Wall <color=yellow>Catacombs</color>', Desc=''
Wall_Simple_C~LavaCaves~MOD:	Title='Free Wall <color=yellow>Lava Caves</color>', Desc=''
Wall_Simple_C~Necropolis~MOD:	Title='Free Wall <color=yellow>Necropolis</color>', Desc=''
Wall_Simple_C~Sewers~MOD:	Title='Free Wall <color=yellow>Sewers</color>', Desc=''
Wall_Simple_D~Catacombs~MOD:	Title='Free Wall <color=yellow>Catacombs</color>', Desc=''
Wall_Simple_D~Necropolis~MOD:	Title='Free Wall <color=yellow>Necropolis</color>', Desc=''
Wall_Simple_E~Catacombs~MOD:	Title='Free Wall <color=yellow>Catacombs</color>', Desc=''
Wall_Simple_E~Necropolis~MOD:	Title='Free Wall <color=yellow>Necropolis</color>', Desc=''
Wall_Simple_F~Catacombs~MOD:	Title='Free Wall <color=yellow>Catacombs</color>', Desc=''
Wall_Simple_G~Catacombs~MOD:	Title='Free Wall <color=yellow>Catacombs</color>', Desc=''
Wall_Simple_LowGround_A~Sewers~MOD:	Title='Free Wall <color=yellow>Sewers</color>', Desc=''
Wall_Thin_Corner_A~Stronghold~MOD:	Title='Thin Wall <color=yellow>Stronghold</color>', Desc=''
Wall_Thin_Corner_B~ElvenPalace~MOD:	Title='Thin Wall <color=yellow>Elven Palace</color>', Desc=''
Wall_Thin_CornerT~ElvenPalace~MOD:	Title='Thin Wall <color=yellow>Elven Palace</color>', Desc=''
Wall_Thin_Link~Stronghold~MOD:	Title='Prison Fence <color=yellow>Stronghold</color>', Desc=''
Wall_Thin_Straight_A~ElvenPalace~MOD:	Title='Thin Wall <color=yellow>Elven Palace</color>', Desc=''
Wall_Thin_Straight_A~Stronghold~MOD:	Title='Thin Wall <color=yellow>Stronghold</color>', Desc=''
Wall_Thin_Straight_B~ElvenPalace~MOD:	Title='Thin Wall <color=yellow>Elven Palace</color>', Desc=''
Wall_Thin_Straight_B~Stronghold~MOD:	Title='Thin Wall <color=yellow>Stronghold</color>', Desc=''
WallCastel_A~Town~MOD:	Title='Free Wall <color=yellow>Town</color>', Desc=''
WallCastel_B~Town~MOD:	Title='Free Wall <color=yellow>Town</color>', Desc=''
WallCastel_Butress_A~Town~MOD:	Title='Butress <color=yellow>Town</color>', Desc=''
WallCastel_Butress_B~Town~MOD:	Title='Butress <color=yellow>Town</color>', Desc=''
WallCastel_C~Town~MOD:	Title='Free Wall <color=yellow>Town</color>', Desc=''
Window_A~ElvenPalace~MOD:	Title='Window <color=yellow>Elven Palace</color>', Desc=''
Window_B~ElvenPalace~MOD:	Title='Window <color=yellow>Elven Palace</color>', Desc=''
Window_C~ElvenPalace~MOD:	Title='Window <color=yellow>Elven Palace</color>', Desc=''
Window_D~Stronghold~MOD:	Title='Window <color=yellow>Stronghold</color>', Desc=''
WoodenFence_Link~ElvenPalace~MOD:	Title='Prison Fence <color=yellow>Elven Palace</color>', Desc=''
WoodenFence_Straight_A~ElvenPalace~MOD:	Title='Prison Fence <color=yellow>Elven Palace</color>', Desc=''
WoodenFence_Straight_B~ElvenPalace~MOD:	Title='Prison Fence <color=yellow>Elven Palace</color>', Desc=''
WoodenPlatform_A~LavaCaves~MOD:	Title='Free Wall <color=yellow>Lava Caves</color>', Desc=''
WoodenPlatform_B~LavaCaves~MOD:	Title='Free Wall <color=yellow>Lava Caves</color>', Desc=''
WoodLog_A~WoodLand~MOD:	Title='Wood Log <color=yellow>Woodland</color>', Desc=''
WoodLog_B~WoodLand~MOD:	Title='Wood Log <color=yellow>Woodland</color>', Desc=''
WoodLog_C~WoodLand~MOD:	Title='Wood Log <color=yellow>Woodland</color>', Desc=''
WoodLog_D~WoodLand~MOD:	Title='Wood Log <color=yellow>Woodland</color>', Desc=''
WorkTable_A~Catacombs~MOD:	Title='Work Table <color=yellow>Catacombs</color>', Desc=''
WorkTable_A~ElvenPalace~MOD:	Title='Work Table <color=yellow>Elven Palace</color>', Desc=''
WorkTable_A~Stronghold~MOD:	Title='Work Table <color=yellow>Stronghold</color>', Desc=''
WorkTable_A~TownInterior~MOD:	Title='Work Table <color=yellow>Town Interiors</color>', Desc=''
WorkTable_B~Catacombs~MOD:	Title='Work Table <color=yellow>Catacombs</color>', Desc=''
WorkTable_B~ElvenPalace~MOD:	Title='Work Table <color=yellow>Elven Palace</color>', Desc=''
WorkTable_B~Stronghold~MOD:	Title='Work Table <color=yellow>Stronghold</color>', Desc=''
WorkTable_B~TownInterior~MOD:	Title='Work Table <color=yellow>Town Interiors</color>', Desc=''
WorkTable_C~Stronghold~MOD:	Title='Work Table <color=yellow>Stronghold</color>', Desc=''
WorkTable_C~TownInterior~MOD:	Title='Work Table <color=yellow>Town Interiors</color>', Desc=''
